史地	历史和地理
正选	正式选举
营运	营业运行
粮播	粮食播种
大运	大学生运动会
金陵女大	金陵女子大学
文委会	文艺委员会
冻藏	冻结保藏
民乐团	民族音乐团
林化所	林业化学研究所
违禁	违犯禁令
特津	特殊津贴
女网	女子网球
建设部	城乡建设环境保护部
北医大	北京医科大学
马约	马斯特里赫特条约
计控	计量控制
广电厅	广播电影电视厅
消联	消费者联合会
中心馆	中心图书馆
支教	支援教育
东亚运	东亚运动会
文体科	文艺体育科
澳大	澳门大学
跳雪	跳台滑雪
技经贸	技术经济贸易
大专	大学专科
准运证	批准运营证
北师大	北京师范大学
铁委	铁路委员会
行政庭	行政审判庭
预赤	预算赤字
手工	手工业
外宾	外国来宾
防署	防止中署
民政办	民政办公室
文管	文物管理
勘检	勘查检验
商住小区	商业住宅小区
复健	恢复健康
工业所	工业经济研究所
幼师	幼稚园教师
革委会	革命委员会
普调	普遍向上调整
建照	建筑执照
邯钢	邯鄣钢铁总厂
红读活动	全国红领巾读书读报活动
经联会	经济联合会
价改	价格改革
城建办	城市建设办公室
西交会	中国西部商品交易会
厅局委办	厅局委办公室
扩产	扩大产量
禁用	禁止使用
光机电	光学机械和电子
男板	男子跳板跳水
铁总	铁路总工会
横联	横向联合
邮联	邮政联盟
自选	自行选购
承保	承接保险
招飞办公室	招收飞行学员办公室
达产	达到规定的产量
粮菜	粮食和蔬菜
亲美	亲信美国
影馆	电影馆
军法系	军事法律系
小水电	小型水电站
增补	增加补充
太煤	太原煤矿
主创人员	主要创作人员
中汽	中国汽车工业总公司
长托	长期住校的托儿制度
重犯	重新违法犯罪
技改费	技术改造费
省报	省级报纸
职灾	职业灾害
环幕	环形银幕
军情	军事情报
乌铁	乌鲁木齐铁路局
北工大	北方工业大学
送检	送交检验
银改办	银行改革办公室
陶艺	陶瓷艺术
调研	调查研究
中国足协	中国足球协会
经济庭	经济审判庭
医卫体	医疗卫生体育
建材	建筑材料
中直工委	中央直属机关工作委员会
增收	增加收入
北平艺专	北平艺术专科学校
沈铁	沈阳铁路局
长联会	沿长江城市企业联谊会
政协	中国人民政治协商会议
节支	节约开支
暨大	暨南大学
组派	组织派遣
亚视	香港亚洲电视广播有限公司
禁毒办	禁毒办公室
世界拳协	世界拳击协会
中百	中国百货公司
租管	租金管制
总裁办	总裁办公室
制销	制造和销售
幼教	幼儿教育
中直	中央直属机关
工矿	工厂和矿山
射距	射击距离
国保	国家重点文物保护
军警宪特	军队警察宪兵特务
国奥	中国奥林匹克足球队
省高院	省高级检察院
冬泳	冬季游泳
劳效	劳动效率
扶残	扶助残疾人
计量标准	计量标准器具
承建	承担建设
美协	美术家协会
控申	控告申诉
帮办	帮助办公室
旅团	旅行团
限价	限定价格
台港澳侨	台湾香港澳门华侨
治沙办	治理沙漠办公室
工青妇	工会青年团和妇联
开赛	开始比赛
国际学联	国际学生联合会
区教办	区教育办公室
经侦科	经济侦察科
谍参队	军事谍报参谋队
面值	票面价值
贸发理事会	贸易和发展理事会
影艺	电影艺术
普中	普通中学
劳协	劳动协会
中师	中等师范学院
兵总	兵器工业总公司
植检	植物检疫
全国人大	全国人民代表大会
舞研所	舞蹈研究所
边城	边境城市
高小	高级小学
调处费	调查处理的费用
伙委会	伙食管理委员会
收视	收看电视
城理	香港城市理工大学
亚太	亚太地区
伤亡	受伤死亡
免诉	免予起诉
眼防所	眼病防治所
评聘	评定和聘任
协处	协助处理
企管站	企业管理站
保健医	保健医生
兵运	士兵运动
巨资	巨额资金
人防委	人民防空委员会
中央工艺美院	中央工艺美术学院
财税局	财政税务局
侨办	国务院华侨事务办公室
违诺	违反承诺
外资办	外资办公室
中国泳协	中国游泳协会
政院	政治学院
越中	越南中国
海洋所	海洋研究所
全息术	全息照相术
影本	电影剧本
内异症	子宫内膜异位症
夏休	夏季休养
私房	私人住房
纺运	纺织品运输
时流	时代潮流
冶金部	冶金工业部
拉美经委会	拉丁美洲和加勒比经济委员会
化奥	化学奥林匹克竞赛
劳保所	劳动保护科学研究所
植化	植物化学
经纪会	香港证券经纪业协会
家教会	家庭教育研究会
主政	主持政务
省人大	省人民代表大会
排雷	排除地雷
留职	保留职务
供运科	供销运输科
职辅所	职业训练辅导所
轻纺化	轻工业纺织化工
普训	普及培训
英足总	英国足球总
列支	列项支出
劝募	劝说征募
反右	反右派斗争
世界针联	世界针灸联合会
成部	成都部队
外企	外商投资企业
工总	工业总会
企管部	企业管理部
小试	小规模试制
中唱	中国唱片总公司
选委会	选举委员会
球阀	球形阀
少先队	中国少年先锋队
调人	调解的人
汇展	汇报展览
摄录编	摄像录音编辑
自排	自动排档
外商	外国商人
绍酒	绍兴酒
保监会	中国保险监督委员会
工疗站	工人疗养站
人教司	人事教育司
经技开发区	经济技术开发区
产供销用	生产供应销售使用
港台新马	香港台湾新加坡马来西亚
精仪	精密仪器
伊盟	内蒙古自治区伊克昭盟
口岸办	口岸办公室
计办	计划办公室
长汽	长春第一汽车制造厂
创演	创作和演出
航权	航空运输权
核试	核武器试验
贵航	贵州航空公司
减免	减少和免除
慈协	慈善协会
劣品	劣质商品
长三	长征三号
流港	流人香港
照排	照相排版
武警部队	中国人民武装警察部队
外运	对外运输
一商局	第一商业局
中国质协	中国质量管理协会
中国曲协	中国曲艺家协会
中油	中国石油工程建筑公司
反干扰	反电子干扰
青联节	青年联欢节
防总办	防汛总指挥部办公室
商检部门	进出口商品检验部门
大高外	大规模高技术外向化
围殴	围攻殴打
前指	前线指挥部
保健办	保健办公室
边检站	边防检查站
春训体测	春季训练体能测试
四化	四个现代化
构设	构划设想
自筹资金	自筹投资资金
建署	香港建筑署
签令	签署命令
技改	技术改造
电离计	电离真空计
留美	留学美国
地勘	地质勘查
财会	财务和会计
地富反坏	地主富农反革命分子坏分子
西梆	西部梆子
邮工	邮政工会
肃特	肃清特务
钓协	钓鱼协会
通关	通过海关
艺协	艺术家协会
农林牧	农业林业牧业
增幅	增长幅度
律考	律师考试
托老	托老所
自动线	自动生产线
地热电站	地球热能发电站
政府办	政府办公室
联大	联合国大会
司训	司机训练
拒载	拒绝载客
职改办	职称改革办公室
退休办	退休办公室
话检	电话机质量检测
运输方案	铁路运输综合作业方案
肝衰竭	肝功能衰竭
静点	静脉点滴
议转平	议价转平价
男单	男子单打
直政处	直属党委政治处
镜检	内窥镜检查
效颦	东施效颦
严控	严格控制
税检室	税务检查室
铁桥	铁路和桥梁
上视队	上海电视台队
文传	文字传递
体念	体会感念
引智	引进国外智力
有机所	有机化学研究所
东救	东北民众救亡总会
赞好	称赞叫好
特聘	特别聘用
残奥	残疾人奥林匹克运动会
婚龄	结婚年龄
港股	香港股市
钻饰	钻石首饰饰品
内庭	内部审判庭
劳酬	劳动报酬
国际柔联	国际柔道联合会
普高线	普通高中录取分数线
个贷	个人贷款
统战政协	统一战线政治协商
房建段	房屋修建段
教科院	教育科学研究院
赛项	比赛项目
标样	标准样品
工学	工作和学习
亚太律协	亚洲太平洋律师协会
敌档	敌方档案
美特	美国特工人员
太地	香港太古地产有限公司
航检	航空检查
中共	中国共产党
委主任	居民委员会主任
实小	实验小学
分获	分别获得
中秘	中文秘书
南亚联盟	南亚区域合作联盟
世俱赛	世界俱乐部赛
非殖民化特委会	联合国非殖民化特别委员会
航邮	航空邮寄
工经	工业经济
全委会	全体委员会议
中软	中国计算机软件与技术服务总公司
妇幼	妇女和幼儿
特混舰队	特殊混合舰队
水旱	水田和旱地
规章	规则和章程
联考	联合考试
报审制	报审制度
道协	道教协会
彩色管	彩色显像管
厂商会	香港中华厂商联合会
棉办	棉花办公室
硕导	硕士生导师
革命军	中国国民革命军
初小	初级小学
保队	保加利亚队
节水	节约用水
文体活动	文娱体育活动
国际篮联	国际业余篮球联合会
面授	当面讲授
乡教办	乡镇教育办公室
游资	游离闲散的流动资金
自办	自学考试办公室
名址	姓名和地址
抗敌	抗击敌人
参拍	参加拍摄
卫电师训	卫星电视师资培训
船管站	船只管理站
交安员	交通安全员
省委	中国共产党省委员会
文史	文学和历史学
裁谈会	裁军谈判会议
国企办	国有企业办公室
日皇	日本天皇
续贬	继续贬值
车管	车辆管理
普建	普遍建立
一纵	第一纵队
运五	运输五型
文抗	文艺界抗敌后援会
上展	上海展览中心
陆积	陆地面积
合成油	合成绝缘油
港康体局	香港健康体育发展局
长话线	长途电话线
自研	自行研制
民艺品	民间艺术品
廉租屋	廉租公屋
上海国立音专	上海国立音乐专科学校
避税	逃避缴税
天地生	天文地理生物
商住楼	商业住宅楼房
手编	手工编织
北青报	北京青年报
超额	超过定额
文体	文娱体育
协办	协助举办
海遂	海底遂道
职总	职工总会
内人党	内蒙古人民革命党
检测	检查和测试
工美	工艺美术品
人大办	人大办公室
教厅	教育厅
运保费	运输保险费
农办	农业办公室
工代会	工代大会
团队	共青团和少先队
商包	商品邮递包裹
普高	普通高级中学
航管	航运管理
法梧	法国梧桐树
文联社	中外文艺联络社
劳防	劳动防护
长输	长途运输
铁四院	铁道部第四勘测设计院
汇拨	汇款拨款
市容委	市容管理委员会
行纪	行业纪律
国际科协	国际科学工作者协会
国家防总	国家防汛抗旱总指挥部
抗日联军	东北抗日联军
粮校	粮食学校
城运	城市运动会
涨跌	上涨或下跌
扫黄办	扫黄办公室
新运	国民党的新生活运动
职校	职业学校
三峡办	三峡工程审查委员会办公室
北方左联	北方左翼作家联盟
德行	品德行为
料耗	材料消耗
拖滞	拖拉滞后
玉烟	云南玉溪卷烟厂
髓检	骨髓检查
14中	第114中学
剧评	戏剧评论
劳军	慰劳军队
宣口	宣传口
13中	第13中学
艺研所	艺术研究所
班务	班级事务
纺大	中国纺织大学
审期	审理期限
建乡	建立乡政府
厄军	厄军队
人委	人民委员会
中专生	中等专业学校学生
社劳党	社会主义劳动党
解危	解决危房问题
招标办	招标办公室
化校	化学工业学校
世俱杯	世界俱乐部杯
外专	外语专科学校
信用社	信用合作社
世拳理	世界拳击理事会
助选	辅助选举
亚行	亚洲开发银行
手绣	手工刺绣
农推	农业技术推广
军转工作	军队转业干部安置工作
晤商	会晤协商
立委	立法委员会委员
诉案	诉讼案
广涉	广泛涉及
外经贸	对外经济贸易
帮教办	帮助教育办公室
民转公	民办教师转为公办教师
文工队	文化艺术工作队
娱宾	娱乐嘉宾
内资片	内部资料影片
亚洲自联	亚洲自行车联合会
学代会	学生代表大会
电专	电力高等专科学校
光机所	光学精密机械研究所
简托	简易托儿所
正反	正面与反面
拖欠款	拖延和差欠贷款
科贸中心	科技贸易中心
奥校	奥林匹克学校
刑侦	刑事侦查
特救队	特种救援队
高中低	高级中级和低级
地税征管	地方税务征收管理
网联	网球联合会
乙脑	乙型脑炎
核物理	原子核物理学
纺针	纺织针织
客货轮	客货两用轮
联中	联合中学
洗理费	洗澡理发费
文秘	文书秘书
文博	文物博物
剧专	戏剧专科学校
换俘	交换俘虏
长发公司	长江经济联合发展股份有限公司
民选政府	民主选举的政府
待产	等待生产
推普	推广普通话
轻卡	轻型卡车
还贷	偿还贷款
医械	医疗器械
查补	追查补缴
工业废物	工业固体废物
农大	农业大学
外理	外轮理货公司
公汽公司	公共汽车公司
贪案	贪污案件
武委	武术委员会
女举赛	女子举重锦标赛
孤寡老弱	孤儿寡妇老人和体弱者
中小教联	中学小学教师联合会
菜办	蔬菜办公室
青工部	青年工作部
边检处	边防检查处
伤俘	受伤战俘
男警	男性警察
海派	上海派
深房	深圳住房
查控	检查和控制
复转	复员和转业
北昆	北方昆曲
政协办	政协办公室
溶共	溶化共产党
澳网	澳大利亚网球公开赛
戏协	戏剧家协会
苏欧集团	苏联东欧集团
水电暖	自来水供电暖气
世象联	世界象棋联合会
成铁局	成都铁路局
自民党	自由民主党
拳总	拳击总会
体疗	体育医疗
地研所	地质研究所
谈资	谈话的资料
支边	支援边疆
核发	审核发放
汽修厂	汽车修理厂
残工委	残疾人工作委员会
集蔬运	集装箱蔬菜运输
工副	工业副业
民青	民主青年同盟
核销	审核销账
普九	普及九年制义务教育
邮署	香港邮政署
妇委会	妇女委员会
应化所	应用化学研究所
元白	元稹和白居易
东柳	东部柳子
开审	开始审讯
贵冶厂	贵州冶金厂
机院	机械学院
二外	第二外国语学院
捐输	捐献输出
师培	师资培训
能办	能源办公室
妇幼站	妇女幼儿保健站
高函	高等函授学院
农管会	农业综合开发管理委员会
梅派	梅兰芳派
查核	查证核实
澳姐	澳门小姐
世青赛	世界青年锦标赛
编撰	编辑撰写
中转	中间转播
南飞厂	南昌飞机制造厂
华资	华人资金
农职校	农村职业学校
塑化	塑料化工
公贿	公款行贿
火炬办	火炬接力办公室
高顾委	高级顾问委员会
纺机	纺织机械
预审	预先审议
曲韵	戏曲音韵
登协	登山协会
皮塑	皮革和塑料
预研	预备性研究
中邮	中国集邮总公司
铅排	铅字排版
调资	调整工资
青联	中华全国民主青年联合会
仲裁委	仲裁委员会
推展	推销和展览
国际自联	国际业余自行车联合会
菲妓	菲律宾籍妓女
戈腔	戈阳腔
名导	著名导演
澳队	澳门队
外汇局	外汇管理局
国际象棋奥赛	国际象棋奥林匹克团体赛
技考委员会	技术考核委员会
险工段	危险工程段
宪草	中华人民共和国宪法草案
煤机厂	煤矿机械厂
新例	新条例
随顺	随机顺应
中行	中央银行
土改	土地改革
援藏	支援西藏
国际桥联	国际桥牌联合会
美货	美国货物
三棉	第三棉纺织厂
治保	治安保卫
科联	中华全国自然科学专门学会联合会
文艺	文化艺术
考量	考虑衡量
从艺	从事艺术工作
设伏	设下伏兵
调试	调节和测试
政法委	政法委员会
军大	军政大学
佛协	佛教协会
茶料	茶叶作料
冰联	冰球联合会
菌痢	细菌性痢疾
技干	技术干部
全日空	全日本航空公司
停航	停止航行
常服	平常服装
镇暴	镇压暴徒
中东和会	中东和平国际会议
报摘	报纸文摘
政研会	思想政治工作研究会
戏研	戏剧研究
光缆	光纤通讯电缆
女举	女子举重
优诊	优先诊疗
团市委	中国共产主义青年团市委员会
拳操	拳术和体操
机电部	机械电子工业部
搜毒	搜查毒品
自组	自己组建
交运	交通运输
职称办	职称评定办公室
办案	侦办案件
残障	生理残疾行动障碍者
青基会	青少年发展基金会
书报刊	图书报纸期刊
复退	复员退伍
忠勇	忠诚勇敢
技委会	技术委员会
扶价	扶持价格
改危	改造危房
城管委会	城市管理委员会
老促会	中国老区技术开发研究促进会
文代会	文学艺术工作者代表大会
地卫站	地面卫星接收站
内退	内部退休
悬拼法	悬臂拼装法
滥权	滥用职权
固体火箭	固体推进剂火箭
文总	文化总同盟
上财	上海财经大学
乒乓赛	乒乓球比赛
全国工商联	中华全国工商业联合会
背姿	背部姿势
宿位	住宿床位
非工统	非洲工会统一组织
国际共运	国际共产主义运动
个调税	个人收入调节税
化医	化学医学
海务	海上事务
岸基	岸上军事基地
半坡遗址	半坡氏族遗址
缔婚	缔结婚约
中国商检总公司	中国进出口商品检验总公司
土肥	土壤和肥料
央航	中央航空公司
个私经济	个体私营经济
团十三大	中国共产主义青年团第十三次代表大会
裁核	裁减核武器
广电部	广播电影电视部
财厅	财政厅
市政委	市政工程委员会
清房办	清理党政干部违法违章违纪建私房办公室
中央血防办	中央血吸虫病防治办公室
晨训	早晨训练
经协办	经济协作办公室
新航	新加坡航空公司
财院	财经学院
植物生理所	植物生理研究所
职训	职业训练
浦开办	浦东开发办公室
质检所	质量检测所
干属	干部家属
参评	参加评比
杭扇	杭州扇子
刑诉法	刑事诉讼法
婚俗	结婚的习俗
台港澳	台湾香港和澳门
党训班	党员培训班
婴幼	婴儿幼儿
退约	退出条约
音体美	音乐体育和美术
南共体	南部非洲发展共同体
托保	托儿和保育
教统司	教育统筹司
削权	削弱权力
亚洲田联	亚洲业余田径联合会
超凡	超脱凡俗
图品	图书制品
街童	露宿街头的流浪儿童
刑释解教	刑满释放解除劳教
年伐量	森林年平均采伐量
临管会	临时管理委员会
潜研	潜心研究
医研	医学研究
客货	旅客和货物
南汽	南京汽车制造厂
家财	家庭财产
艺档	艺术档案
马华领袖	马来西亚的华人领袖
京昆	京剧和昆剧
甲亢	甲状腺功能亢进症
院规	学院规章
投标书	投标标书
白权	白人特权
注资	注入资金
春播	春季播种
哈飞	哈尔滨飞机制造公司
宫外孕	子宫腔外受孕
群文司	群众文化司
联销	联合展销
汉大	汉城大学
首展	首次展览
协理员	协助管理员
查缴	查获收缴
主计	主任会计
规条	规定条款
排解	排除和解决
完中	完全中学
台教联盟	台湾教师联盟
警号	警示信号
城建	城市建设
舞美	舞台美术
参赌	参加赌博
软饮	软饮料
煤科	煤炭科学
匈民联	匈牙利民主联盟
丁肝	丁型肝炎
超产	超额生产
财税系统	财政税务系统
全锦赛	全国锦标赛
农医	农村医疗
心防	心理防线
南侨	南洋华侨
编录	编辑和录音
汉绣	武汉刺绣
沈冶	沈阳冶炼厂
制博会	装备制造业博览会
委购	委托收购
职级	职务和等级
速递权	快速邮递权
教参	教学参考资料
亲邻	亲朋邻居
房管	房产和地产管理
女干	妇女干部
升幅	上升幅度
一编室	第一编辑室
社工	社会群众工作
盲流	盲目流动
中芭	中央芭蕾舞团
中共地委	中国共产党地区委员会
团寿险	团体人寿保险
公选	公开选举
中控	中央控制
批零差	批发与零售的价格差额
行包	行李包裹
纠偏	纠正偏差或偏向
查获	侦查破获
科情所	科学情报研究所
四野	中国人民解放军第四野战军
成飞	成都飞机
考纲	考试大纲
盲杖	盲人手杖
劳资料	劳动工资料
本益比	本金与收益的比
基民党	基督教民主党
黑白管	黑白显像管
附中	附属中学
中华艺大	中华艺术大学
保险额	保险金额
武警	武装警察
整党	整顿党风
储汇	储蓄和汇兑
审查委	审查委员会
中纺部	中国纺织工业部
侨商	华侨商业银行
停播	停止播放
德智体美	德育智育体育美育
牙防	牙病防治
登联	登山联合会
航运	航海运输
双拥办	双拥办公室
名特优	名牌产品特产产品优质产品
森防站	森林防护站
专志	专心致志
访京	访问北京
助教	助理教师
康体活动	康乐体育活动
计经委	计划经济委员会
长航	长江航运
体表	身体表面
旅协	旅游协会
中奥队	中国奥林匹克足球队
农业实产量	农业税实际产量
觅探	寻觅探视
考廉	考核清廉
机扫	计算机扫描
华师大	华东师范大学
南太地区	南太平洋地区
地质所	地质研究所
封杀	封闭扼杀
录干	录用干部
检评考	检查评比考核
农科站	农业科技站
农机局	农业机械局
内供	内部供应
总体设计	总体规划设计
权责	权力和责任
航拍	航空拍摄
咨监	咨询监察
质检权	质量检验权
重审	重新审查
海损	海洋运输损失
工农商学兵	工人农民商人学生和士兵
电表	电测量指示仪表
屋宇署	香港屋宇地政署
青科协	青年科技工作者协会
亚羽联	亚洲羽毛球联合会
戏文系	戏剧文学系
林果	林业果业
外侨	外籍侨民
贿选	贿赂选举
公共关系公司	公共关系咨询公司
高职	高级职务
代培	代为培养
普初	普通初中
青运史	青年运动史
天山厂	天山电影制片厂
人防	人民防空
内政办	内政办公室
速递	快速投递
菜点	菜肴和点心
农研室	农村政策研究室
台大	台湾大学
户政科	户籍政策科
石化部	石油化工部
工委会	工作委员会
夜运	夜间运输
体改司	体制改革司
国小	国立小学
印厂	印刷厂
邮管局	邮电管理局
纪监	纪律监督
松阀厂	松花江阀门厂
八机部	第八工业机械部
严治	严格治理
评文	评论文章
卫检	卫生检疫
管输	管道输送
机校	机械学校
劳模	劳动模范
核射	核电辐射
安恬	安适恬静
集游法	集会游行法
供暖办	供暖办公室
五十五中	第五十五中学
工委	工作委员会
重百	重庆百货
军力	军事力量
北无	北京无线电
羽交会	羽绒制品交易会
赛果	比赛结果
路桥隧	公路桥梁隧道
贩毒	贩卖毒品
老干	老干部
国际航联	国际航空运动联合会
宣导	宣传引导
海陆空	海港陆路航空
组委	组织委员会委员
租赁办	租赁办公室
仓管员	仓库管理员
收治	接收治疗
外汉词典	外语和汉语双语词典
专修科	专业进修科
越权	超越权限
幼托	幼儿入托
安检	安全检查
高空站	高空气象站
太保	中国太平洋保险公司
公屋	公共房屋
花农	种花为业的农民
硬卧	硬席卧铺
文保	文物保护
适销	适合销售
展团	展览团
节食	节制饮食
拒斥	拒绝排斥
维和部队	联合国维持和平部队
大篮协	大学生篮球协会
科技社	科学技术出版社
注析	注释与分析
激辩	激烈争辩
手机	手提式无线电话机
调训	调整和训练
借占	借调和占用
油组	石油输出国组织
义警	义务警察
煤检费	煤炭检查费
病患者	病人患者
组展会	组织展览会
乌市	乌鲁木齐市
查堵	检查堵截
未保委	未成年人保护委员会
观通站	观察通讯站
刚布	刚果布拉柴维尔
青协	青年协会
防疟	防治疟疾
公职会	澳门公职人员协会
大学生体联	大学生体育联合会
回邮	回寄邮资
研订	研究制订
轨检车	铁路轨道检查车
木机厂	木工机械厂
国贸	国际贸易
农展	农业展览会
行评	行业评比
械劫	持械枪劫
商粮科	商品粮审计科
阪神	大阪神户
保联	保龄球联合会
参院	参议院
军民	军队和人民
建政	建设政权
脊灰	脊髓灰质炎
排协	排球协会
读博	攻读博士学位
工体	北京工人体育场
自防	自身防范
莎学	研究莎士比亚的学术
值宿	值班住宿
外资处	外商投资管理处
总政	红军总政治部
自护	自我保护
价量	价格与成交数量
日经联	日本经营者团体联盟
福铁	福州铁路
司政后	司令部政治部后勤部
外援	外来援助
洋教	洋教练
双租	双倍租金
文理	文科理科
数理化	数学物理化学
长话	长途电话
仓容	仓库容量
费负	费用负担
运能	运输能力
石化厅	石油化学工业厅
团支部	共青团支部
常委会	常务委员会
引介	引导介绍
玻柜	玻璃柜
中小幼	中学小学幼儿园
妇检	妇科检查
隧巴	隧道巴士
试产	试行生产
职大	职工大学
豪轮	豪华游轮
初中	初级中学
中国影协	中国电影家协会
文协	中华全国文艺界抗敌协会
网协	网球协会
农电网	农村电网
民诉	民事诉讼
监控	监察和控制
工运	工作运动
黄窝	黄色物品窝点
延赛	延后比赛
劫匪	抢劫的匪徒
点校	对古籍标点校订
消协	消费者协会
武总招	武警总队招待所
春运	春节旅客运输
铁五局	铁道部第五工程局
共市	欧洲共同市场
陶玻业	陶器玻璃业
自民	自由民主
泳手	游泳选手
德智体	德育智育和体育
名词委	名词委员会
抽佣	抽取佣金
四医大	中国人民解放军第四军医大学
直流	直流电
集资办	筹集资金办公室
专储	专项储备
购股	购买股票
珍调队	珍贵动物资源调查队
地空导弹	地对空导弹
倒炭	倒买倒卖煤炭
纺院	纺织工业学院
机译	机器翻译
空导弹	空对空导弹
风骚	国风和离骚
红高	红色高棉
轻机所	轻工业机械研究所
年均	每年平均
商管委	商业管理委员会
客层	顾客层
特快	特别旅客快车
船检	船舶和海上设施检验
商事	商业事务
厦大	厦门大学
捐赠办	接收救灾捐赠办公室
雕绘	雕刻绘画
公意	公民意愿
平转议	平价转为议价
淠史杭	淠河史河杭河
民研所	民族研究所
机具	机械和工具
外经贸部	对外经济贸易部
考核办	考核办公室
农负	农民负担
科考队	科学考察队
军机	军事机密
心外科	心血管外科
民先	中华民族解放先锋
护龄	护士工龄
中录公司	中国录音录像公司
铁科院	铁路科学研究院
体卫	体育卫生
塑胶	塑料像胶
中日友好世委会	中日友好21世纪委员会
总工会	中华全国总工会
华东师大	上海华东师范大学
矿管局	矿产资源管理局
中国田径协会	中国田径运动协会
军干	军队干部
工行	中国工商银行
航标	助航标志
敌工	敌区工作
国开行	国家开发银行
上工	上海工业
承责	承担责任
筛汰	筛选淘汰
自考	高等教育自学考试
宣教科	宣传教育科
串星	客串影星
警校	警察学校
上球	上海制球联合公司
玻纤院	玻璃纤维研究院
照排机	照相排字机
设陷	设置陷阱
邮储	邮政储蓄
瓜菜代	瓜果蔬菜代粮充饥
展延	展缓延长
培干	培养干部
外航	外国航空公司
港九	香港九龙
禁会	禁止开会
世运会	世界运动会
党支书	党支部书记
上医	上海医科大学
慢支炎	慢性支气管炎
梅剧团	梅兰芳剧团
民品	民用品
关员	海关人员
农影	农业电影制片厂
降损	降低损耗
保贷	担保贷款
女乒	女子乒乓球队
国烟局	国家烟草专卖局
长管	长期管理
工发组织	联合国工业发展组织
勋业	功勋事业
老庄	老子和庄子
果菜业	水果蔬菜行业
片源	影片来源
冰啤	冰镇啤酒
一助一	一个帮助一个
残联	残疾人联合会
梅拳	梅花拳
亚乒	亚洲乒乓球
政法大	政法大学
待援	等待援助
少队部	少年先锋队队部
累亏	累计亏损
民兵运动会	民兵军事体育运动会
政经	政治经济学
震兆	地震的征兆
港报	香港报纸
农水	农田水利
党代会	党代表大会
工展馆	工业展览馆
昆虫所	昆虫研究所
触法	触犯法律
话剧所	话剧研究所
爱顾	爱护照顾
家装	家居装饰
亚证	亚洲证券国际有限公司
工农	工人和农民
槛总	香港橄槛球总会
二十一中	第二十一中学
工交财贸	工业交通业财政和贸易
花纱布	棉花棉纱棉布
伊协	伊斯兰教协会
水保站	水土保持工作站
童军	童子军
校警	学校警卫
广交会	广州中国出品商品交易会
轻轨	轻型轨道
乞服	乞丐服装
赏罚	奖赏处罚
一中	第一中学
社科系	社会科学系
校董会	学校董事会
保安	保卫安全
食协	食品工业协会
中资企业	中国投资的企业
受教	接受教育
届退	届龄退休
纺校	纺织工业学校
公汽	公共汽车
国资办	国有资产办公室
发股	发行股票
陶建	陶瓷建筑材料
企标	企业标准
研修	研究进修
治绩	政治业绩
编程	编制程序
省高法	省高级人民法院
中青报	中国青年报
中央美院	中央美术学院
中青	中国青年
芭团	芭蕾舞团
党刊	政党的机关刊物
苏俄	苏联俄国
节粮	节约用粮
长项	擅长的项目
薪常会	香港公务员薪俸及服务条件常委会
水改旱	水田改为旱地
博管办	博士后管理协调委员会办公室
总长	总参谋长
钦崇	钦佩崇敬
参编	参加编写
保赔保险	保障赔偿责任保险
治太	治理太湖
教工	教员职员和工人
吧女	酒吧女郎
工安	工业安全
滞港	滞留香港
联汇制	联系汇率制度
矿机厂	矿山机器厂
经参处	经济参赞处
康梁	康有为梁启超
管输费	管道输送费
产需	生产需求
国际铁联	国际铁人三项联合会
阿语	阿拉伯语
德育	品德教育
服化道	服装化妆和道具
牌告	挂牌公告
京菜	北京菜系
民贸	民族贸易
统战	统一战线
人媒	人体媒介
艺师	艺术师范学校
国际曲棍联	国际曲棍球联合会
汽摩公司	汽车摩托车联合制造公司
亚锦赛	亚洲锦标赛
土改部	土地改革部
蔬菜办	蔬菜供应办公室
农工副	农业工业副业
学额	学生名额
节庆	节日庆典
粮价	粮食价格
密语	密码语言
球圈	球类运动员圈子
光控	光线控制
特技	特殊技能
职教	职业教育
船期	轮船舰行日期
财长	财政部部长
党争	党派争斗
寒暑期	寒暑假期间
计委	计划委员会
尊干爱兵	尊警干部爱护士兵
化疗	化学药物治疗
民进	中国民主促进会
产险	产品险
牌费	车牌费用
列制	排列制成
索费	索取费用
奥运	奥林匹克运动
恐资病	恐惧资本主义之病
高法	中华人民共和国最高人民法院
杂优	杂交优质品种
供销料	供应销售料
工产	工业生产
内处	内部处理
电工部	电力工业部
科幻	科学幻想
团青联	团员青年联合委员会
高二	高中二年级
顾委	顾问委员会
校护	学校护士
行址	银行地址
空冷器	空气冷却器
三十九中	第三十九中学
外经证	固定工商企业外出经营税收管理证明单
班厦	班达拉奈克国际会议大厦
升等	上升等级
标粉	标准面粉
摩阻力	摩擦阻力
时限	时间限制
农工委	农村工作委员会
重整	重新整建
党政警民	党组织政府部门警察民众团体
康体中心	康乐体育中心
上仪所	上海仪器仪表研究所
东方台	上海东方电视台
国际箭联	国际射箭联合会
65中	第65中学
高教法	高等教育法
普惠制	普遍优惠制度
秘招	秘密绝招
持旺	持续旺销
特府	特区政府
国际合联	国际合作联盟
住总	住宅建设总公司
德新社	德意志新闻社
粮管所	粮食管理所
村公所	村民委员会办公所
社改	社会改革
拒礼	拒绝收受礼品
国家体改委	国家经济体制改革委员会
投发部	投资开发部
世协	世界语协会
演职	演员职员
二八车	二十八英寸自行车
工交	工业和交通业
救治	抢救和治疗
房署人员	香港房屋署人员
首体	首都体育馆
路局	铁路局
匪特	土匪和特务
癌变	癌症病变
音效	音响效果
供卫	提供保卫
交委	交通委员会
水陆空	水上陆地空中
共青团	中国共产主义青年团
委贷	委托贷款
短贷	短期贷款
计控室	计量控制室
亚体联	亚洲体操联合会
遏抑	遏止抑制
商统会	商业统一促进会
房修	房屋修理
青保	青少年保护
区县	区或县
教研	教学研究
动检科	动物检疫科
痴狂	痴迷与疯狂
城调局	城市调查局
工交建商贸	工业交通建筑商业和贸易
激唱	激光唱机
立审	立案审查
支扩	支气管扩张
冬亚会	冬季亚洲运动会
交大	交通大学
灭治	消灭和防治
证监员	香港证券期货交易监督员
贪贿	贪污和受贿
禁毒委	禁毒委员会
农职中	农村职业中学
禾草	禾木科牧草
敌友	敌人和朋友
共识	共同的认识
阿联航	阿拉伯联合航运公司
外策	外交政策
高开区	高技术开发区
农体协	农民体育运动协会
邮挂	邮件挂号
节油	节约用油
抽检	抽样检查
电工局	电器工业管理局
邮运	邮政运输
劳技课	劳动技术课
知青点	知识青年插种队落户点
专办	专案办公室
驾校	汽车驾驶员培训学校
英相	英国首相
弃教	放弃教学
精仪厂	精密仪器厂
海洋科委会	海洋研究科学委员会
反黑	反击黑社会
中通社	香港中国通讯社
东影	东北电影制片厂
执罚	执行罚没
月均	每月平均
旅业议会	旅游业评议会
户粮	户口及粮油供应
支副	支援副业
年运量	年运输量
政工	思想政治工作
联营	联合经营
科办	科技办公室
人大会堂	人民大会堂
贸经	贸易和经济
病检	病理检查
泳联	游泳联合会
世界羽联	世界羽毛球联合会
安居办	安居工程办公室
影视所	电影电视研究所
手检	手工检索
航意险	航行意外险
畜科所	畜牧科学研究所
失忆	失去记忆
土杂公司	土产日用品杂品公司
洛拖研究所	洛阳拖拉机研究所
数显	数字显示
乘委会	乘客委员会
国际体育记联	国际体育记者联合会
发包	签发承包合约
研考	研究生入学考试
监检	监察和检察
冲放	冲洗放大
保育会	战时儿童保育会
脱贫	摆脱贫困
牢监	牢房监狱
高专	高等专科学校
高自联	高等教育自学考试联合会
抛股变现	抛售股票变成现金
误述	错误地叙述
电讯	电子通讯
住房办	住房办公室
八五计划	中华人民共和国经济和社会发展第八个五年计划
包商	承包商
停售	停止销售
电子办	电子工业办公室
运邮	运送邮件
空管	空中交通管理
和会	和平谈判会议
扩招	扩大招生
平直遥	平面直角遥控
普测	普遍测量
调焦	调整焦距
嫉羡	嫉妒羡慕
港闻版	香港新闻版
B股	B种股票
中央台	中央电视台
调运	调拨运输
合成革	人工合成皮革
经洽会	经济技术合作洽淡会
华约	华沙条约
二轻局	第二轻工业局
剧毒品	剧毒性商品
竞委会	竞赛委员会
内保	单位内部的保卫
国际桥协	国际桥梁及结构工程协会
采行	采用实行
增优限劣	增加优质产品和限制劣质产品
安理会	安全理事会
展演	展览演出
口讯	口语资讯
海装部	海军装备技术部
核减	审核消减
曲联	曲棍球联合会
俄城	俄国城市
抗审	抗拒审讯
声学所	声学研究所
友赛	友谊赛
科协	科学技术协会
贸工技	贸易工业技术
合资	联合投资
经一庭	经济审判第一庭
政争	政治斗争
面的	面包车型的士
中国排协	中国排球协会
心战	心理战木
地调所	地质调查所
解阵党	解放阵线党
女探	女警探
新华社	新华通讯社
企改	企业综合改革
二八	台湾二二八起义
营建	营房建筑
果粮	瓜果和粮食
税控	税收控制
社保费	社会保险费
信贷款	信用贷款
国际排联	国际排球联合会
架构	框架结构
精仪系	精密仪器与机械学系
工贸	工业和贸易
民族宫	北京民族文化宫
空运	航空运输
法制办	法制办公室
棉贷	棉花贷款
等离子体所	等离子体研究所
存废	保存或废除
特支	特别支部
定补面	定期补助面
十届	第十届
南非共	南非共产党
控检	控制检查
普内	普通内科
教联会	香港教育工作者联会
杭二棉	杭州第二棉纺织厂
鲸委	捕鲸委员会
港岛	香港岛
北视	北京电视艺术中心
关工委	关心下一代工作委员会
沈汽	沈阳汽车工业公司
资遣	资助遣返
交安委	交通安全委员会
党中央	党的中央委员会
职技	职业技术
企业委	企业委员会
世界射联	世界射击联合会
报警	报告警方
军地	军队和地方
增支	增加支出
一勘局	第一勘测局
长三角	长江三角洲
时政	时事政治
科技	科学技术
外游	出外旅游
残运	残疾人运动会
工休	工间休息
二次大战	第二次世界大战
收售	收购和出售
化交会	化学工业商品交易会
安师大	安徽师范大学
体事	体育赛事
亚举联	亚洲举重联合会
译协	翻译工作者协会
炒汇	炒卖外汇
青训	青年培训
工农商	工业农业和商业
地税局	地方税务局
党代	党的代表
劝退	劝说退出
银系	银河系
农畜	农业畜业
商交所	商品交易所
统筹	统一筹划
军控	军备控制
空爆	空中爆炸
沪办	驻沪办事处
彩录	彩色录像
工企管	工业企业管理
扫丑	扫除各种丑恶现象
钱江	钱塘江
公审	公开审判
消委会	消费者委员会
家床科	家庭病床科
轻工厅	轻工业厅
羽协	羽毛球协会
稳顺	稳健顺利
农改办	农业改革办公室
国姐	国家小姐
夏奥会	夏季奥林匹克运动会
少儿基金会	少年儿童基金会
中软总公司	中国计算机软件与技术服务总公司
中纺机	中国纺织机械股份有限公司
工改	工资制度改革
针感	针刺感应
工卫旅	工业卫生和旅游
世拳协	世界拳击协会
斟洽	斟酌洽谈
奥赛	国际学科奥林匹克竞赛
农机办	农业机械办公室
社队	人民公社和生产大队
体悟	体会领悟
壁饰	墙壁装饰
广协	广告协会
防汛办	防汛办公室
中银	中国银行
观通	观察通讯
女师	女子师范学校
合堵	联合堵截
密商	秘密商量
自控联	自动控制联合会
组屋	组合房屋
运程	命运进程
五十四中	第五十四中学
参试	参加试验
掌控	掌握控制
交通量	交通流量
刑事技术	刑事科学技术
民运	少数民族运动会
狱务	监狱事务
武委会	武术委员会
老幼	老年人幼儿
暗迷	暗淡迷蒙
特形	特殊形体
附小	附属小学
房行	住房储蓄银行
世青	世界青年
遣俘	遣返战俘
学具	学习用具
老区	老解放区
升贬	升值和贬值
建交	建立外交关系
产供	生产供应
非基运动	非基督教运动
二机部	第二机械工业部
全员	全体成员
驼绒	骆驼绒
婚育	结婚生育
纪检委	纪律检查委员会
油市	石油市场
严斥	严厉斥责
航模	航空模型
征补	征集和补充
法改会	香港法律改革委员会
农研所	农业科学研究所
高研班	高级研讨班
自供	自我供给
钢研	钢铁研究
情治单位	情报统治单位
中教	中等教育
国大党	印度国民大会党
军统	国民政府军事委员会调查统计局
春管	春季田间管理
家访	家庭访问
芭赛	芭蕾舞比赛
普客	普通旅客列车
打假	打击制售假冒伪劣商品
四角法	四角号码检字法
通联站	通讯联络站
欧行	欧洲之行
僚气	官僚习气
黄赌毒娼	黄色赌博毒品和嫖娼
督查办	监督检查办公室
三干会	三级干部会议
毙伤	击毙和击伤
保教人员	保望教育人员
亚大区	亚洲和大洋州地区
受益证券	信托受益权证券
蒸疗	蒸汽治疗
林果竹	林业果业竹业
投审会	台湾投资审议委员会
献血办	献血办公室
文体用品	文教体育用品
委管	委托管理
定点	确定地点
降本	降低成本
超生	超计划生育
微生物所	微生物研究所
民负	人民负担
街委会	街道居民委员会
作协	作家协会
公援	公共援助金
国贸科	国际贸易科
社经	社会经济
军转办	军队转业干部安置办公室
铁十一局	铁道部第十一工程局
商界	商业界
舞校	舞蹈学校
检控	检察指控
干训班	干部培训班
德通社	德意志通讯社
语料	语言材料
时控	时间控制
消保法	消费者保护法
五小	第五小学
朝医	朝鲜族医学
汽修业	汽车修理行业
首汽	首都汽车公司
数学所	数学研究所
老慢支	老年慢性支气管炎
粮棉油	粮食棉花和油料作物
文哲所	文学哲学研究所
反导系统	反弹道导弹系统
政工师	政治工作师
考博	报考博士研究生
篮管	篮球管理
五交站	五金交电采购供应站
镇反	镇压反革命
民乐	民族音乐
动因	动机原因
排管	排水管道
评选办	评选办公室
重机	重型机器
福影	福建电影制片厂
京棉	北京棉纺厂
职中	职业中学
组干处	组织干部处
上图	上海图书馆
男双	男子双打
临管处	临时管理处
包建	承包兴建
就业办	就业办公室
澳毛	澳大利亚所产羊毛
台资	台湾资金
值守	值班守护
空陆海	空军陆军海军
性防中心	性病防治研究中心
拓销	拓展外销
博协	博物馆协会
吨粮田	亩产一吨粮食的田
小交会	小型交易会
财专	财经专科学校
球卡	球员卡
经委办	经济委员会办公室
转速表	转速测量仪表
油气钻探	石油天然气钻探
普教科	普通教育科
中程	中等射程
沈大	沈阳大学
版协	出版协会
球技	打球技术
哈瓦斯社	哈瓦斯通讯社
专校	专科学校
教科文卫工委	教育科学文化卫生工作委员会
名医	著名医生
坝电	大坝发电厂
中土	中国土木工程公司
勘景	勘查外景
童装	儿童服装
亚运	亚运会
爆冷	爆冷门
警黑	警方与黑社会
二产	第二产业
共同社	共同通讯社
中央后委	中央后方工作委员会
社盟	社会联盟
工大	工业大学
单阐	单门船阐
陆校	陆军学校
渔捞	渔业捕捞
卫司	香港卫生福利司
拒腐防变	拒腐蚀防蜕变
民柬	民主柬埔寨
立法办	立法办公室
登顶	登上顶峰
干湿	干燥湿润
民建	中国民主建国会
卫训队	卫生员训练队
宣教办	宣传教育办公室
败因	失败原因
薪给	薪水供给
马航	马来西亚航空公司
国际举联	国际举重联合会
音专	音乐专科学校
援建	援助建设
五黑	五号黑体字
学优	学习成绩优异
演训班	演员培训班
狮隧	香港狮子山隧道
雪米糍	雪糕糯米糍
环保科研所	环境保护科学研究所
精粗长驼	精纺呢绒粗纺呢绒长毛绒驼绒
一职高	第一职业高中
戊肝	戊/Mg 型病毒性肝炎
理工农医	理科工科农科和医科
贸发会	贸易和发展会议
发钞	发行钞票
世行	世界银行
二商局	第二商业局
宾主	来宾和主人
供求	供应和需求
花冰	花样滑冰
支乡	支援家乡
周秦汉唐	周朝秦朝汉朝唐朝
杭嘉湖	杭州嘉兴湖州
入签局	入境签证局
成教	成人教育
中国社科院	中国社会科学院
支农办	支农办公室
艺小	艺术小学
促销	促进销售
现局	现实局势
体卫处	体育卫生处
区委办	区委办公室
防痨	防治痨病
纺企	纺织企业
线损	线路损耗
联交所	香港联合交易所
编制	编写制定
坡改梯	坡地改成梯田
文工团	文艺工作团
资委会	国民党政府资源委员会
农技员	农业技术人员
美音体	美术音乐和体育
高教自考	高等教育自学考试
集训	集中训练
受阅	接受检阅
全独	全部独用
摄录设备	摄像机录像机设备
密投	秘密投寄
高教	高等教学
电教室	电化教育实验室
基法推介会	基本法推介联席会议
贷实	贷放实物
大体联	大学生体育联合会
婚介业	婚姻介绍产业
惩教	惩罚教育
增收节支	增加收入节省支出
百优活动	百日优质服务竞赛活动
外籍轮	外国籍的轮船
北京体院	北京体育学院
国际足联	国际足球联合会
扫毒	扫除毒品
驱梅	驱除梅毒
农学会	农业科学学会
泪弹	催泪弹
控编	控制编制
世锦赛	世界锦标赛
违纪	违反纪律
助耕	帮助耕种
团工委	中国共产主义青年团工作委员会
普小	普通小学
金管局	香港金融管理局
日杂	日用杂货品
仲裁办	劳动争议仲裁委员会办公室
打印	打字与印刷
市管费	市场管理费
热采	热力开采
国府	国民政府
联校	联合学校
组训	组织训练
农调队	农村社会经济调查队
危房	危险房屋
声像	声音图像
农资	农业生产资料
化肥	化学肥科
控爆	控制性爆破
少管所	少年管教所
西大	西北大学
水保所	水土保持研究所
城巴	城市巴士
桥遂	桥梁和遂道
改土治碱	改良土壤治理盐碱地
外劳	外地劳工
女泳	女子游泳
中国少儿社	中国少年儿童出版社
拥吻	拥抱和亲吻
邮码	邮政编码
体改	体制改革
一轻局	第一轻工业局
支前	支援前线
器识	器度和胆识
民建联	香港民主建港联盟
亚武联	亚洲武术联合会
越战	越南战争
城市理工	香港城市理工大学
防办	防汛总指挥办公室
供毒	供应毒品
中旅	中国旅行社
脱险	脱离危险
宋瓷	宋代瓷器
林科院	林业科学院
49中	第49中学
政法学会	政治法律学会
卫福司	香港卫生福利司
兽防站	兽防治站
车联	赛车联合会
编务	编辑业务
美报	美国报纸
莎剧	莎士比亚戏剧
施麻	施行麻醉
计免	计划免疫
多动症	多动综合症
现值	现实价值
搪协	搪瓷协会
广空	广州军区空军部队
干群	干部和群众
共运史	共产主义运动史
清队	清理阶级队伍
农工商贸	农业工业商业贸易
采制	采摘制作
导修课	辅导自修课
汪辜会谈	汪道涵辜振甫会谈
乒协	乒乓球协会
内审	内部审计
彝胞	彝族同胞
省思	反省思考
推普周	推广普通话周
脑瘫	大脑瘫痪
中运会	中学生运动会
教一楼	教学一号楼
排污	排放污水
思政司	思想政治工作司
诚正	诚实正派
导盲	引导盲人行动者
择偶	选择配偶
意甲	意大利甲级联赛
职高生	职业高中学生
功模	功臣模范
儿保所	儿童卫生保健所
关协	关心下一代协会
少共国际	少年共产国际
裁军	裁减军备
开发办	开发办公室
少儿社	少年儿童出版社
南委	中共中央南方工作委员会
老少边困	革命老区少数民族地区边境地区困难地区
报备	申报备案
临客	临时旅客列车
综贸	综合贸易
食杂店	食品杂货店
农险处	农业保险处
特护队	特殊护理队
铁三局	铁道部第三工程局
食宿行	伙食住宿出行
远教	远距离教育
三机部	第三机械工业部
农牧林	农业牧业林业
画艺	绘画艺术
上证Ｂ股	上海证券Ｂ股
公交	公共交通
老体协	老年人体育协会
亚洲摔委	亚洲摔跤委员会
帆联	帆船运动联合会
纺科院	纺织科学研究院
外排	向外排水
停检	停车检查
中央交通部	中央人民政府交通部
汽训营	汽车训练营
商运	商业运输
委培生	委托培养的学生
反封建	反对封建主义
长影	长春电影制片厂
上重厂	上海重型机器厂
首师大	首都师范大学
低幼	低龄幼儿
青救会	青年救国联合会
经委	经济委员会
儿艺	儿童艺术
军检	军事检察院
煤卫	煤气和卫生设备
物构所	物质结构研究所
报请	报告请示
吸纳	吸收接纳
中煤总公司	中国统配煤矿总公司
择优	选择优秀者
国际乒联	国际乒乓球联合会
亚洲柔联	亚洲柔道联合会
伊通社	伊拉克通讯社
民运会	少数民族运动会
内控	内部控制
尼共	尼泊尔共产党
开放办	开放办公室
东汽	东风汽车公司
告申庭	告诉申诉审判庭
纪委会	纪律委员会
计生员	计划生育技术员
助师	助理工程师
协寻	协助寻找
中残联	中国残疾人联合会
警总	警备总部
牧副渔	牧业副业渔业
祭仪	祭奠仪式
射锦赛	射击锦标赛
党政军群	党组织政府部门军队群众
克族	克罗地亚族
农药械	喷撒农药用的机械
美编室	美术编辑室
婚产育	结婚生产和教育
贸赤	贸易赤字
真空行协	中国真空电子行业协会
空地勤	空中及地面勤力
印报	印度报纸
党工妇青	党委会工会妇女联合会青年团
军体	军事体育
多经	多种经营
院务会	学院事务会议
产供销贸工牧	生产供应销售贸易工业牧业
试销	试行销售
婚庆	结婚庆典
民管会	民主管理委员会
南航	南方航空公司
抗台	抗御台风
帮理	帮助料理
智残	智力残疾
林大	林业大学
普六	普及六年制义务教育
红遂	红勘海底遂道
车市	汽车市场
中修	中期维修
防叛	防止叛乱
八运	第八届运动会
销场	销售市场
外经部	外经贸部
图洽会	图书洽谈会
轻纺	轻工业和纺织工业
教代会	教师代表大会
储贷	储蓄和贷款
币改	货币制度改革
城近郊	城市近郊区
亚太经合	亚洲太平洋经济合作
季检	季度检查
中建	中国建筑工程总公司
泊地	锚泊地
中试所	中心试验所
外来办	接待外来人员办事处
收教所	妇女收容教育所
商誉	商业信誉
待工	等待工作
西飞	西安飞机工业公司
独资	独立投资
报业	报纸出版业
大本	大学本科
外委会	外交委员会
内招	内部招收职工
剖验	解剖检验
国家体委	国家体育运动委员会
狱侦	狱内侦查
荣军	荣誉军人
党政军民学	党组织政府部门军队民众团体学生
贫协	贫农协会
北航	北京航空航天大学
中商部	中国商业部
远南运动会	远东及南太平洋地区运动会
技防办	技术预防办公室
复交	恢复外交关系
市百货	市百货公司
错休	错开休息时间
基干	基层骨干
社店	出版社和书店
一运公司	第一运输公司
采标	采用国际标准和国外先进标准
草委会	起草委员会
俄通社	俄罗斯通讯社
外经技公司	对外经济技术合作公司
路港贸	铁路港务和外贸
高知	高级知识分子
参展	参加展览
文革	无产阶级文化大革命运动
夺魁	争夺魁首
伏休	伏季休渔
流盗扒	流窜盗窃和扒窃犯
煽情	煽动和挑逗情绪
天马厂	天马电影制片厂
日铁	日本铁路
外空法学	外层空间法学
漱洗	漱口和洗脸
化机厂	化工机械厂
企登	企业登记
外经贸委	对外经济贸易委员会
森工局	森林工业局
音美	音乐美术
产加销	生产加工销售
粮农组织	联合国粮食和农业组织
农发所	农村发展研究所
社保处	社会保险费事业处
体师	体育师范学校
南模	上海南洋模范中学
化工所	化学工业研究所
滑联	滑冰运动联合会
特混	特殊混合
古塑	古代雕塑作品
采分编流	采购分类编目流通
托价	托高楼价
女手	女子手球
私烟	走私香烟
医界	医疗界
慢支	慢性支气管炎
梅鹿	梅花鹿
拥塞	拥挤堵塞
犯行	犯法行为
审批	审查批准
空姐	空中小姐
阿社盟	阿拉伯社会主义联盟
征管	征收和管理
环评	环境评估
基社盟	基督教社会联盟
成科大	成都科技大学
专才	专业人才
测绘	测量绘制
宣教部	宣传教育部
民自党	民主自由党
善信	善男信女
城乡	城市和乡村
退教协	退休教师工作协会
股份公司	股份制有限公司
上交所	上海证券交易所
火电站	火力发电站
军科院	军事科学院
黄贩	出售黄色出版物的商贩
制播	制作和播出
外经公司	对外经济贸易公司
欧杯	欧洲国家杯
水规院	水利规划设计院
金大	金陵大学
土委会	香港土地委员会
文宣办	文化宣传办公室
雕艺	雕刻艺术
邮检	邮件检查
一监	第一监狱
污控司	污染控制司
车险公司	汽车保险公司
排联	排球联合会
续降	继续下降
彩塑	彩色塑料
农工党	中国农工民主党
促请	敦促请求
展演点	展览演出点
上纺	上海纺织工学院
航摄	航空拍摄
放疗	放射性治疗
协和	协和式飞机
质监	质量监督
农化品	农业化学品
体认	体会认识
上消	上海消防
发牌	发放营业牌照
参战	参加作战
荣军院	荣誉军人休养院
刑检	刑事检察
利废	利用废物
质管部	质量管理部
私货	走私货品
老弱妇幼	老年人体弱者妇女和幼儿
质评	质量评定
五交化机	五金交电化工机械
上菱厂	上菱电冰箱总厂
连运	连续运输
救总	中国人民救济总会
区计委	区计划委员会
中运网	中国运输网
马列文论	马克思列宁主义文艺理论
保畜	保护牲畜
国家工商局	国家工商行政管理局
葬仪	安葬仪式
公安干警	公安机关的干部和警察
民促会	香港民主政制促进联委会
军教片	军事科学教育影片
区府	市辖区人民政府
义演	义务演出
河界	楚河汉界
安检站	安全检查站
证交税	证券交易税
译联	翻译工作者联合会
经团联	日本经济团体联合会
房建	房屋修建
农械	农业机械
培训	培养和训练
叶贺	叶挺和贺龙
共盟	共产主义者联盟
农贷	农业贷款
禁销	禁止销售
半导体所	半导体研究所
换汇	换取外汇
农博会	农业博览会
商机	商业机械
控温	控制温度
中常会	国民党中央常委会
七运会	第七届全国运动会
出访	出国访问
审俘	审讯俘虏
香港教联	香港教育工作者联合会
北方交大	北方交通大学
园管局	园林管理局
文档	文书档案
财纪	财经纪律
视导员	巡视指导员
助选员	助理竞选员
供销	供应和销售
村小	村办小学
基盘	基础地盘
珠影	珠江电影制片厂
科工协会	科学工作者协会
清匪	肃清土匪
特困	特殊困难
化工部	化学工业部
申领	申请领取
军管会	军事管制委员会
乒总	乒乓球总会
管协	香港管理专业协会
欧风	欧洲风味
研讨会	研究讨论会
医具	医疗器具
军供站	军需品供应站
教委	教育委员会
冬运会	冬季运动会
核武库	核武器库
帮补	帮助补贴
江防	长江防务
抗震办	抗震办公室
黄漂	黄河漂流探险
电站	发电站
党政群	党组织政府部门群众
非洲民联	非洲民主联盟
邮倒	邮票倒卖者
破抗	破伤风抗毒血清
参农	种参的农民
创建办	创建文明城市办公室
港警	香港警察
中纪委	中央纪律检查委员会
军售	军火销售
限电	限制用电
经适房	经济适用房
庭审	法院开庭审判
国际铁协	国际铁路协会
品改	品种改良
微刻	微型雕刻
青教办	青少年教育办公室
中青网	中国青年网
收审所	收容审查所
工商专联	香港工商专业联合会
机运	机械运输
集企	集体企业
电话办	电话办公室
工勤	工作人员勤杂人员
音教	音乐教育
特区	经济特区
星箭	卫星和火箭
工农兵	工人农民和士兵
航保	航行保卫
胆石	胆囊结石
卡匣	磁卡匣
解纷	解决纷争
腊八	农历腊月初八
省话	省话剧团
省控	省级控制
冠心病	冠状动脉粥样硬化性心脏病
微书	微型书法
妇工委	妇女工作委员会
潜亏	潜在亏损
鼓倡	鼓励提倡
民选	民众选举
采写	采访编写
销假	销毁假货
赞羡	称赞和羡慕
书家	书法家
海工	中国人民解放军海军工程学院
筹展	筹备展出
控购办	控制社会集团购买力办公室
南热厂	南京热电厂
黄带	黄色录像带
纺工部	纺织工业部
谈艺	谈论艺术
合作企业	中外合作经营企业
大运村	大学生运动员村
进侵	进攻侵犯
上证Ａ股	上海证券Ａ股
测评	测验评定
机电仪产品	机械电器和仪表产品
招委	招生委员会
粮企	粮食企业
麻防	麻风病防治
据考	根据考证
长科院	长江科学研究院
金银	金牌银牌
安盟	争取安哥拉彻底独立全国联盟
青训班	青年培训班
安协	安慰协会
书研会	书法教育研究会
错时	错开上下班时间
川棉	四川棉花
女篮	女子篮球队
玉柴	玉林柴油机总厂
招飞	招收飞行学员
楼股	楼房股票
植生所	植物生理所
军政	军事和政治
农轻重	农业轻工业和重工业
抗联会	抗日联合会
政训班	政治工作培训班
农机	农业机械
供校	供销商业学校
农改	农业改革
南中	南开中学
法新社	法国新闻社
特训	特别训练
查扣	查封扣留
核武	核武器
渔技	渔业技术
答询	答复质询
耗资	耗费资金
安保部	安全保卫部
特困户	特别困难户
市办	市委办公室
首发式	首次发行仪式
蚁防	白蚁防治
扩频通信	扩展频谱通信
青运会	青年体育运动会
临机局	临时机场管理局
南工团	南下工作团
统战部	统一战线工作部
防总	防汛总部
市务	市场业务
机电署	机电工程署
执纪	执行纪律
党总支	党的总支部委员会
质保	质量保证
道指	道琼斯股票价格平均指数
拘控	拘捕和指控
人大法	中国人民大学图书分类法
流旷生	流学旷课的学生
化脑	化脓性脑膜炎
深交会	深圳交易会
自营	自己经营
家化	家用化妆品
特惠	特别优惠
慢萎	慢性萎缩性胃炎
肩周炎	肩关节周围炎症
奥运会	奥林匹克运动会
代职	代理任职
警讯	警察讯问
世青足球赛	世界青年足球锦标赛
粮机厂	粮食机械厂
亚卫一号	亚洲卫星一号
师咨会	香港师训与师资咨询委员会
运毒	运送毒品
外佣	外籍女佣
中执委	国民党中央执行委员会
物理所	物理研究所
剧改	戏剧改革
体锻	体育锻炼
纪特	纪念特种
商粮	商品粮
公疗	公费医疗
欧共体	欧洲经济共同体
宪警	宪兵和警察
外联处	对外联络处
机动科	机械动力科
甲癣	指甲癣
规费	规划费用
彩纸	彩色相纸
游将	游泳健将
扣缴义务人	代扣代缴义务人
提干	提拔干部
推麻	推拿麻醉
欧盟	欧洲联盟
炒股	炒买炒卖股票
财困	财政困难
救捞	救助和打捞
外教	外籍教师
孔孟	孔子和孟子
速录	快速录音
金钞	黄金与现钞
南化	南京化学工业公司
沙研所	沙漠治理研究所
影视	电影和电视
编更	编排轮更值夜班
民诉法	民事诉讼法
罪案	犯罪案情
棉产	棉花生产
外贸协会	台湾对外贸易发展协会
戏曲所	戏曲研究所
改阅	修改批阅
地院	地质学院
风雅	国风大雅小雅
战罪	战争罪行
特区办	特区办公室
北戈	北方戈阳腔
反腐介廉	反对腐败介导廉政
拒收	拒绝接收
建委	基本建设委员会
生防室	生物病虫防治研究室
上广厂	上海广播器材厂
药化	药物化学
保定军校	保定军官学校
罗新社	罗马尼亚新闻社
房津	房屋津贴
工农商学	工人农民商人和学生
国际社	国际社会服务社
铁十五局	铁道部第十五工程局
港同盟	香港民主同盟
婚介所	婚姻介绍所
律管处	律师管理处
双晚稻	双季晚稻
词作	词作者
轮涨	轮番上涨
增干	增加干部
印控区	印度控制区
民促联	香港民主政制促进联委会
电化铁路	电气化铁路
边贸	边境贸易
运管费	运输管理费
办展	举办展览
安和	安定祥和
联办	联合举办
澳府	澳门政府
车模	汽车模型
储粮	储存粮食
干审处	干部审查处
工农比价	工农业商品交换比价
首旅	首都旅游
速中	速成中学
安莎社	安莎通讯社
牛丸	牛肉丸子
深证Ｂ股	深圳证券Ｂ股
环姐	环球小姐
经济林	经济特种林
经管	经济管理
裁退	裁减辞退
铁运	铁路运输
中执会	国民党中央执行委员会
暴富	暴发致富
波幅	波动幅度
妇教所	妇女教养所
华大	华东军政大学
文班	文科班
副贴	副食品价格补贴
期金	期货资金
羽总	香港羽毛球总会
联查	联合检查
射联	射击联合会
澳门草委会	澳门基本法起草委员会
西北工大	西北工业大学
国际拳联	国际业余拳击联合会
国际手联	国际手球联合会
收录	收音和录音
农改局	农业改革局
文管所	文化管理所
亚乒赛	亚洲乒乓球锦标赛
查房办	清查住房办会室
整复	整形复原
足校	足球学校
马岛	马尔维纳斯群岛
全国妇联	中华全国妇女联合会
编办	编辑部办公室
乐疗	音乐治疗
印尼	印度尼西亚
社科所	社会科学研究所
支青	支边青年
支铁	支援铁路建设
约通社	约旦通讯社
中太保	中国太平洋保险公司
外代	外轮代理公司
微机	微型计算机
速冻	快速冷冻
再障	再生障碍性贫血
海协	大陆海峡两岸关系协会
维园	香港维多利亚公园
技交会	技术交易会
禁演	禁止演映
粮贸	粮食贸易
文联	文学艺术家联合会
文管会	文物管理委员会
机位	飞机位置
兽药	兽用药
规范办	规范办公室
刚金	刚果金
拜金	崇拜金钱
粮管	粮食管理
网羽	网球羽毛球
守防	守卫边防
肃托	肃清托派分子
禁见	禁止会见
业界	产业界
市总	市总工会
铁八局	铁道部第八工程局
赛制	比赛制度
青话	青年话剧团
联供	联合供应
艺展局	香港演艺发展局
哈磁厂	哈尔滨磁化器厂
行管局	行政管理局
公退金	公务员退休金
混料	混合原料
税负	所得税的负担
村助	村长助理
农干校	农村干部培训学校
评先	评选先进
中训团	国民党中央训练团
一百	第一百货商店
民院	民族学院
大运会	大学生运动会
技革	技术革新
污管科	污染管理科
产能	生产能力
货代	货物运输代理
放贷	发放贷款
全纺会	全国纺织品交易会
反霸	反对恶霸
中少队	中国少年足球队
上镜	上镜头
银贸	银行外贸
兰铁局	兰洲铁路局
批汇单	批准兑换外汇单
先模	先进模范
普教	普通教育
施暴	施行强暴
灭螺	消灭钉螺
美叙	美国叙利亚
食油	食用植物油
翠戒	翡翠戒指
开荒	开垦荒地
菌检	细菌检查
减员	裁减工作人员
桥协	中国桥牌协会
农管局	农业管理局
罚没	罚款和没收
户养	分户饲养
艺委会	艺术教育委员会
中央教育部	中央人民政府教育部
津沽	天津塘沽
中青队	中国青年队
企管处	企业管理处
尸表	尸体表面
笔龄	笔耕的年龄即指从事写作的年头
劳司	劳动服务公司
心内科	心血管内科
优品	优质产品
经管站	经济管理站
节电	节约用电
统考	统一考式
贪渎	贪污与渎职
照制	照相制版
女装	女子服装
野外津贴	野外工作津贴
勤管处	后勤工作管理处
无照	无牌照
临商户	临时经商户
国防委	国防委员会
药检	药品检验
南师	南京师范大学
坦承	坦白承认
幼园	幼儿园
受让	接受转让
政文	政治文艺
展交会	展览交易会
首选	首要选择
髋脱位	髋关节脱位
文管局	文化管理局
国基	国家基础
航修	航次修理
药专	药材专科学校
技农工	技术农业生产和工业生产
协龄	协会会龄
峨影	峨嵋电影制片厂
空列	空驶列车
校办	校长办公室
译配	翻译并配词
输劳	输出劳务
高中	高级中学
妇委	妇女委员
区政	区政府
电研所	电子研究所
临立会	临时立法委员会
市人大	市人民代表大会
粮豆	粮食和豆类作物
书协	书法家协会
精实	精致充实
证监	香港证肆期货交易监督委员会
物交会	物资交易会
丙型肝炎	丙/Mg 型病毒性肝炎
农建	农业建设
展馆	展览馆
敌工部	敌区工作部
外片	外国影片
中专	中等专业学校
空投	空中投送
开方	开药方
敌特	敌方特务
访摄	采访拍摄
炮研所	炮兵防空兵装备技术研究所
办退	办理离休退休手续
保额	保险金额
筹组	筹备组织
正倒班	正顺序倒班法
反贪局	反贪污贿赂工作局
会审	会同审查
钻采	钻探开采
收存	收藏保存
政团	政治团体
世博村	世界博览村
材质	材料质量
短跑	短距离赛跑
学平险	学生平安保险
扩建	扩大建设
韩食	韩国食品
对外友协	中国人民对外友好协会
浙美	浙江美术
影视剧	电影电视和戏剧
群疑	群众的疑惑
软网	软式网球
反帝	反对帝国主义
菲佣	菲律宾籍佣人
五十六中	第五十六中学
地矿局	地质矿产局
峰会	高峰会议
技联	技巧联合会
除颤	消除颤抖
低俗	低级庸俗
空司	空军司令部
工商贸	工业部门商业部门和贸易部门
展览办	展览办公室
军艺	中国人民解放军艺术学院
儿研所	儿童少年卫生科学研究所
北航食	北京航空食品有限公司
集贸	集市贸易
银企	银行和企业
购销	收购和销售
海练	海上训练
管控	管理控制
石药	石家庄药业
强劳	强制性劳动教育
协查办	协助调查办公室
群体	群众体育
科教	科学和教育
德智体美劳	德育智育体育美育和劳动教育
一棉厂	第一棉纺织厂
亚贸会议	亚洲贸易促进会议
奥运村	奥林匹克体育运动员村
创意	创新意识
科仪	科学仪器
夹屋	夹心阶层房屋
寸照	一寸照片
支哮	支气管哮喘病
土特	土产特产
欧陆	欧洲大陆
战债	战争债务
独联体	独立国家联合体
奉派	奉命被委派
省优	省级优质产品
窥研	窥探和钻研
国贴	国家发放的政府特殊津贴
彩玻	彩色显像管玻壳
车损险	汽车损坏保险
困恼	困扰苦恼
攀钢	攀枝花钢铁公司
重钢	重庆钢铁公司
税警局	税务警察局
摩配	摩托车配件
纤支镜	纤维支气管镜
赏购	欣赏和购买
经监	经济监察
能委	能源委员会
宇联	宇宙航行联合会
文电文电	文涵和电讯文件和电话
篮协	篮球协会
生源	学生来源
长防林	长江防护林
两制	两种制度
法捕房	法租界巡捕房
乡干	乡干部
诈骗	诈骗行为
抗改分子	抗拒劳动改造分子
跌幅	下跌幅度
草委	起草委员
长话市话	长途电话市内电话
工研院	工业研究院
申评会	申诉评议委员会
统整	统一整合
海监室	海上安全监督室
厂矿	工厂和矿山
农林牧副渔	农业林业牧业副业渔业
南侨总会	南洋华侨筹赈祖国难民总会
送审	送交审查
国际跤联	国际业余摔跤联合会
老中青少	老年中年青年少年
飞播林	飞机播种的树林
黑雨讯号	黑色暴雨警告讯号
捕办	逮捕法办
乙链	乙型溶血性链球菌
平教会	中华平民教育促进会
白喉杆菌	白喉棒状杆菌
咨委	咨询委员会
嫌犯	嫌疑犯
整团	整顿团组织
上港	上海港务局
以德	以色列德国
团训班	团干部训练班
申办委	申请举办委员会
中旅集团	中国旅行社企业集团公司
教资会	大学及理工教育资助委员会
考绩	考察政绩
呼中	呼和浩特中学
四纵	第四纵队
政宣	思想政治宣传
生化	生物化学
无核国	无核武器国家
深股	深圳股票
主控室	主要控制室
建养	建筑和养护
矿大	矿业大学
真相委	真相委员会
筹资	筹集资金
音院	音乐学院
基教	基础教育
调薪	调整薪水
削支	削减开支
流脑	流行性脑脊髓膜炎
到训	报到并且接受集训
兴革	振兴改革
海燕厂	海燕电影制片厂
群文	群众文化艺术
展洽会	展览洽谈会
房管局	房产地产管理局
港务局	港务管理局
特政委	特别政治委员会
财赤	财政赤字
化救	化学事故应急救援
电子局	电子工业局
机电科	机械和电力设备科
中情局	美国中央情报局
海基	海上军事基地
军工局	军事工业局
补校	补习学校
候检	等候检查
安技科	安全技术科
二野	中国人民解放军第二野战军
勘测	勘查测量
样车	样本列车
人艺	人民艺术剧院
旅检	旅客检查
编外	编制以外
戴杯	戴维斯杯网球赛
医专	医学专科学校
市政办	市政工程办公室
经援	经济援助
劳资政	劳方资方和政府
光纤	光导纤维
规管	规划管理
武钢	武汉钢铁公司
市容办	市容管理办公室
拖厂	拖拉机制造厂
吸储	吸引储户
彩印	彩色印刷
汉简	汉朝竹简
一附中	第一附属中学
消费效应	消费示范效应
助工	助理工程师
视像	影视图像
工农兵学商	工人农民士兵学生和商人
农林畜	农业林业畜牧业
任免	任命和免职
影评	电影评论
台特	台湾特务
总支	中共总支部委员会
团官	团级军官
锡盟	锡林郭勒盟
经检	经济检察
私宅	私人住宅
罗通社	罗马尼亚通讯社
航测	航空测量
协破	协同侦破
展售	展览销售
林土所	林业土壤研究所
募捐办	募捐办公室
劳动人口	劳动年龄人口
专材	专用材料
家电部	家用电器部
建商	建筑商
诧惊	诧异惊讶
世界劳联	世界劳工联合会
街居	街道居民
竞投	竞相投标
刑案	刑事案件
陆委会	台湾大陆委员会
保盟	保卫中国同盟
木研会	中国木刻研究会
职棒	职业棒球
直销	直接销售
节耗	节约能耗
国际世协	国际世界语协会
敬老	尊敬老人
房改	城镇住房制度改革
反奸	反对汉奸
母婴	母亲和婴儿
文委	文委会
频占费	频率占用费
书研班	书法绘画艺术研讨班
社教部	社会主义思想教育部
孕检	孕娠检查
党办	党委办公厅室
铁一院	铁道部第一勘测设计院
中政校	南京中央政治学校
地检署	地方法院检察署
特警队	特种警察部队
理化生	物理化学生物
移送	移交送达
适称	合适的称呼
托幼	托儿所幼儿园
函销法	用信函销售的方法
收录机	收音和录音两用机
快照	快速照相
轻轿	轻型轿车
旅检处	旅客检查处
黄泛区	黄河洪小泛滥区域
清话	清理电话
监管	监督管理
计征科	计划征收科
党校	共产党的干部培训学校
清装	清代服装
城镇	城市和集镇
西片	西方影片
优教	优秀教师
逃税	逃避税收
波黑	波斯尼亚和黑塞哥维哥那共和国
一简	第一批简化汉字
民转军	民用转为军用
四十三中	第四十三中学
海协会	大陆海峡两岸关系协会
红会	红十字会
公民所	公民律师事务所
夏商周	夏朝商代周代
阐扬	阐述宣扬
工商局	工商行政管理局
教青司	澳门教育暨青年司
电洽	电话洽谈
美侨	美国侨民
试训	尝试训练
上博	上海博物馆
盈亏	盈利和亏本
七冶	第七冶金建设公司
国贸局	国际贸易局
村企	村办企业
农函大	农业函授大学
药管会	医药管理委员会
陆基	陆地基地
劳研所	劳动保护职业病防治研究所
建管委	建筑管理委员会
输移	输送转移
亚大地区	亚洲和大洋洲地区
调资升级	调整工资和晋升级别
康体局	康乐体育发展局
调查委	调查委员会
农技校	农业技术学校
文印部	文件打印部
争创	争取创建
渔改	渔业改革
世排赛	世界排球锦标赛
中美合作所	中美特种技术合作所
创利	创造利润
新旅	新安旅行团
城改	城市改造
方圆委	中国方圆标志认证委员会
续任	继续留任
61中	第61中学
土管	土地管理
地勘局	地质勘探局
纺专	纺织工业专科学校
航途	航行路途
抛股	抛售股票
小教联	小学教师联合会
慈济	慈善救济
大专生	大学专科学生
监委	监察委员会
国际棒协	国际棒球协会
启导	启发引导
史著	历史著作
年胀率	年度通货膨胀率
形象办	形象办公室
田联	田径联合会
卫技	卫生技术
业考	业务考核
绵府	绵阳政府
高息	高额利息
征地	征收土地
电镜	电子显微镜
小公共	小公共汽车
社保局	社会养老保险事业管理局
伪劣	伪造低劣
全国音协	中华全国音乐家协会
蒙通社	蒙古通讯社
开发协会	国际开发协会
攻防	进攻和防守
敌占区	敌方占领区
慈联会	慈善团体联合救灾会
环卫	环境卫生
人口老化	人口老龄化
电振办	电子振兴办公室
妇联	中华全国妇女联合会
工交办	工业交通业办公室
优抚	优待和抚恤
孝政办	孝感政府办公室
工转干	工人身份转为干部身份
人大会	人民代表大会
夜习班	夜晚学习班
党政	党组织政府部门
北外	北京外语学院
棉研所	棉花研究所
局麻	局部麻醉
团友	旅游团朋友
农水司	农田水利司
三审制	三级审稿制度
成棒	成人棒球
护航	保护航行
长防	长江防护
打拐办	打击拐买妇女儿童办公室
妇联会	妇女联合会
大中专	大学和中等专业学校
保通社	保加利亚通讯社
推展会	推销展览会
索偿	索取赔偿金
秦印	秦代印章
市况	市场状况
筹委会	筹备委员会
购囤	收购囤积
校产	校办产业
文物局	文物事业管理局
民众抗日会	上海民众抗日救国联合会
红馆	香港红勘体育馆
函报	用信函报名
基教会	基督教青年会
远东经委会	远东经济委员会
国际田联	国际业余田径联合会
船运公司	船舶运输公司
环保部	环境保护部
技协	技术协会
农水资源	农业水利资源
计财部	计划财务部
农校	农业技术学校
动源	动力源
世博局	世界博览局
表抗	乙型肝炎表面抗原
六百	第六百货
涨幅	上涨幅度
影展	电影展映
整治办	整顿治理办公室
老新协	老新闻工作者协会
党风	党的作风
联储会	联邦储备委员会
蒋管区	蒋介石集团统治管辖的地区
现势	现实形势
铁纪	铁路纪律
大专院校	大学本科或专科学院与学校
一级站	一级采购供应站
宣委	宣传委员
执委	执行委员会委员
治沙	治理沙漠
中国集邮联	中华全国集邮联合会
宣教站	宣传教育站
监改	监督改造
审案	审理案件
影视圈	电影电视圈
八运会	第八届体育运动会
中图法	中国图书馆分类法
彻查	彻底追查
热作	热带作物
勒赎	勒索赎金
北空	北京军区空军部队
甲减	甲状腺功能减退
地方税	地方留用税收
委培	委托培养
六运会	第六届全国运动会
界野	界限分野
移存	转移存入
私物	私人物品
工农医理文法	工科农科医科理科文科和法科
倒烟	倒买倒卖卷烟
外轮	外籍轮船
深影	深圳影业公司
投洽会	投资洽谈会
大远公司	大连远洋运输公司
实务	实际事务
空大	台湾空中大学
粮油	粮食油料
拆装	拆卸与拼装
上重	上海重型机器厂
工联委	香港工业行动联合委员
古建	古代建筑
联动	联合浮动
副总工	副总工程师
省工	节省工时
商博会	商品博览会
中常委	中央常务委员会
农垦	农业垦殖
哈铁局	哈尔滨铁路局
厂医	工厂医生
叙通社	叙利亚通讯社
侨联	中华全国归国华侨联合会
西南交大	西南交通大学
水工系	水利工程系
个展	个人作品展
党史	党的历史
长二捆	长征二号E捆绑式大推力运载火箭
短网	短式网球
二棉	第二棉纺织厂
乡建	乡村建设
智障	智力障碍
亚奥理事会	亚洲奥林匹克运动理事会
护协	护士协会
中国篮协	中国篮球协会
干休所	干部休养所
亚运会	亚洲体育运动会
军管	军事管制
武协	武术协会
战委会	战地动员委员会
防火办	防火办公室
粮运	粮食运输公司
航材所	航空材料研究所
23中	第23中学
歧见	分歧意见
青救	青年救国联合会
欧鳗	欧洲鳗
海司	海军司令部
田协	田径协会
反贪萧贿	反对贪污萧清贿赂
科艺	科学和艺术
加保	加入保险
业校	业余学校
社服	社会服务
考纪	考试纪律
专区社	专区供销合作社
联总	联合国善后救济总署
农发办	农村发展办公室
反共	反对共产党
险种	保险种类型
教科文卫体委	教育科学文化卫生体育委员会
北邮	北京邮电大学
五正	五号正楷字
中教联	中学教师联合会
创评室	创作评论室
实绩	实际业绩
经改	经济体制改革
海缉处	海上缉查处
普幼	普通幼儿园
羽赛	羽毛球赛
职运会	职工运动会
亚篮联	亚洲篮球联合会
消保会	消费者保护协会
一饮公司	第一饮食公司
农经员	农业经济员
企管	企业管理
海运	海洋运输
伊航	伊拉克航空公司
侨领	侨民领袖
美影	美术电影制片厂
陈售	陈列出售
科教文	科学教育和文化
房委会	住房管理委员会
举联	举重联合会
奖惩	奖励和惩罚
文保所	文物保护研究所
高贷	高额贷款
亚洲射联	亚洲射击联合会
全运	全运会
县中	县立中学
本煤	本煤实业公司
赛务	比赛事务
中茶公司	中国茶叶公司
城工部	城市工作部
柬高委	柬埔寨全国最高委员会
体检	体格检查
证券委	证券委员会
超亏	超过政策性亏损数额
企财	企业财产
武运	武术运动
单位信托	单位投资信托
函解	用信函解决
股市	股票市场
港资	香港商业资本
储血	储存血浆
林型	森林类型
世局	世界局势
外联司	对外联络司
索阅	索取阅读
作代会	作家代表大会
羽锦赛	羽毛球锦标赛
建研院	建筑设计研究院
裁武	裁减核武器
女师大	女子师范大学
打办	打击投机倒把办公室
辽吉	辽宁吉林
电联	国际电信联盟
职业培训	职业技术培训
楷草	楷书和草书
包协	中国包装技术协会
总台	总服务台
蒙医	蒙族医学
联汇	联系汇率
一产	第一产业
合同工	合同制工人
反和	反对和平
拆迁	拆除与搬迁
鲜蔬	新鲜蔬菜
统供	统一供应
政研室	政策研究室
老弱病残	老年人体弱者病人和残疾人
报批	申报批准
开征	开始征收
名优	名牌产品优质产品
减缓免	减少缓交免除
商院	商学院
商交会	商品交易会
科委会	科学研究委员会
皮埋法	皮下埋植避孕法
31中	第31中学
农九师	农业第九师
二十三中	第二十三中学
采掘	开采掘进
投信公司	投资信托公司
食宿	伙食住宿
航管中心	航务管理中心
评功表模	评定功绩表彰模范
专控	专项控制
党官	党内官员
帮扶带	帮助扶持带领
快印部	快速印刷部
反帝反殖	反对帝国主义反对殖民主义
政制	政治制度
品资所	品种资源研究所
器泳	带呼吸器的潜泳
更制	轮更制度
社科联	社会科学界联合会
中煤	中国统配煤矿总公司
诗编	诗歌编辑
捕杀	逮捕杀害
特工	特务工作人员
农居	农转居
国训队	国家集训队
军代表	解放军代表
防化	防御化学武器
医科院	医学科学院
铁路办	铁路运输办公室
武空	武汉军区空军部队
教科司	教育科学司
海湾合作委员会	海湾阿拉伯国家合作委员会
公惩会	公务员惩戒委员会
女单	女子单打
外宣	对外宣传
中视	中央电视台
少教	少教人员
港武联	香港武术联合会
住房改革	住房制度改革
亲随	亲信随从
动植	动物植物
支委会	党支部委员会
夏训	夏季训练
中央体委	中央人民政府体育运动委员会
市管会	市场管理委员会
救孤	救助孤儿
技物所	技术物理研究所
肠化	肠腺上皮生化
童影	儿童电影制片厂
严处	严肃处理
粮贴	粮食补贴
场站	停车场和停车站
保淡	保证淡季供应
鲁博	鲁迅博物馆
文体委	文艺体育委员
中国剧协	中国戏剧家协会
肉牛	肉用牛
会展	会议及展览
停耕	停止耕种
刑责	刑事责任
社科院	社会科学院
技农贸	技术农业生产和贸易
检法	检察院和法院
干训	干部培训
渔会	渔民协会
审干	审查干部
结转	结账和转账
高干	高级干部
影协	香港电影业协会
劳动市场	劳动力市场
总参	中国人民解放军总参谋部
公跨铁	公路跨铁路
陆架	大陆架
少科站	少年科学技术指导站
急性尿感	急性尿路感染
染化	染料化学工业
白兰花	白玉兰花
摘金	摘取金牌
客量	客流量
中国版协	中国出版工作者协会
期交所	期货交易所
二十二中	第二十二中学
上钢	上海钢铁公司
政法	政治和法律
统编	统一编写
医训班	医疗培训班
测算	估测计算
肝胆胰	肝脏胆胰脏
徽菜	安徽菜系
内潜	内部潜力
普法	普及法律常识
科农工贸	科技农业工业和贸易
商专	商业专科学校
海政	中国人民解放军海军政治部
创汇	创收外汇
小教	小学教育
举证	举例证明
飞安	飞行安全
生化药厂	生物化学制药厂
公用股	公用事业股
丙肝	丙/Mg 型病毒性肝炎
城管队	城市管理监察队
劳改局	劳改工作管理局
抗战	抗日战争
中知	中级知识分子
客货车	客货两用汽车
坑农	坑害农民
航寄	航空邮寄
协作办	协作办公室
英银	英格兰银行
养教	培养教育
市经	市场经济
党工委	党的工作委员会
政技	政治和技术
统建办	统建办公室
亚银	亚洲开发银行
年均增速	每年平均增速
奥委会	奥林匹克运动委员会
合纤	人工合成纤维
毛选	毛泽东选集
照主	执照主人
质安员	质量安全员
资遣费	资助遣散费
援外	援助外国
枪匪	持枪匪徒
台联	台湾同胞联谊会
社文处	社会文化管理处
人音社	人民音乐出版社
理算	清理计算
医药局	医药管理局
长漂	长江漂流探险
唐院	唐山铁道学院
国际民航组织	国际民用航空组织
公民教委会	公民教育委员会
全运会	全国运动会
音展	音乐展播
捕现	追捕现场
化纤	化学纤维
天磁总厂	天津磁性材料总厂
银票	银行承竞汇票
军训	军事训练
防保	预防保健
开吊	开始吊唁
地测	地质测量
民运部	民众运动部
中国际仲裁委	中国国际经济贸易仲裁委员会
早搏	过早搏动
基地办	基地办公室
均高	平均高度
人口所	人口研究所
诉求	诉讼要求
工技贸	工业技术和贸易
产研	生产研究
优分	优先分配
免签	免予签证
奥申委	奥林匹克运动会申办委员会
粮油肉	粮食油料肉制品
美股	美国股票
汉标	用汉字标音
环委会	环境保护委员会
一师	第一师范学校
主礼	主持典礼
商企管	商业企业管理
亚洲篮联	亚洲篮球联合会
女板	女子跳板跳水
业内	行业内部
儿基会	儿童少年基金会
农膜	农业用塑料薄膜
渔技员	渔业技术员
北展	北京展览馆
经技	经济与技术
红楼	红楼梦
扫盲	扫除文盲
科展	科学知识展览会
铁四局	铁道部第四工程局
商银	商业银行
记谱	记录曲谱
北汽	北京汽车制造厂
手纺	手工纺织
技工	技术工作
华助会	华社自助理会
套现	套取现金
三女师	第三女子师范
地甲病	地方性甲状腺肿病症
一机部	第一机械工业部
涉外	涉及外国
血透	血液透视
驱离	驱逐并使离散
农院	农业学院
台胞	台湾同胞
共建	共同建设
核准	审核批准
特管线	特区管理线
液体导弹	液体推进剂导弹
防左	防止左的路线
地热	地球热能
儿麻	小儿麻痹症
民用院	民用建筑设计院
内刊	内部刊物
测产	预测产量
经研处	台湾经济研究处
主委	主任委员
卡带	卡式磁带
社科司	社会科学司
环保法	环境保护法
儿影	儿童电影制片厂
购批差	购进与批发的价格差额
电传机	电传打字机
婚管	婚姻管理
安内	安定门内
函电	信函电话电报
春交会	春季出口商品交易会
大核	大亚湾核电站
葛电	葛洲坝发电
泰航	泰国航空公司
农副土特	农业产品副业产品社办工业产品和土特产品
工运史	工人运动历史
疏港	疏通港口
机电设协	机械电子工业设备管理协会
晤洽	会晤洽谈
解款车	解送钱款的车辆
共集	共同筹集
乡府	乡政府
汤杯赛	汤姆斯杯赛
肃毒委	肃清毒品委员会
波通社	波兰通讯社
编印发	编辑印刷发行
民校	民办学校
衣食住医	衣服食品居住医疗
邮电	邮政和电信
劫机	劫持飞机
里委	里弄委员会
公德	公共道德
大核站工程	大亚湾核电站工程
医护	医生和护士
国管局	国家管理局
木展	木刻展览
编发	编辑发表
艺委	艺术委员会委员
体模	人体模型
达线	达到规定的分数线
行局	香港行政局
携械	携带枪械
时长	时间长度
世贸	世界贸易
透析	透视和分析
控申科	控告申诉科
过检站	过境检查站
缺失	缺点和失误
税改	税务制度改革
独盟	台湾独立运动联盟
县直	县委和县政府的直属机关
招办	招生办公室
毒资	购买毒品的资金
特护	特级护理
教职	教员职员
中化公司	中国化工进出口总公司
义教省	日本义务教育省
传帮带	传授帮助带动
柔协	香港柔道协会
美院	美术学院
土改运动	土地改革运动
迎检	迎接检查
青企协	青年企业家协会
科研	科学研究
首销	首次销往
乒联	乒乓球联合会
上价	上等价钱
中科院	中国科学院
武备	武器装备
棉检	棉花检验
客管	客运管理
全民	全体公民
农调	农村社会经济调查
中共六大	中国共产党第六次全国代表大会
郊县	城市郊区县
声光电	声音灯光电
劳科所	劳动科学研究所
特卖	特价售卖
证供	证据与供词
行务	银行业务
孤寡	孤儿寡妇
瑞航	瑞士航空公司
美众院	美国众议院
社控	社会集团控制购买商品
殡工	殡葬工人
生理所	生理科学研究所
路考	道路考试
视圈	电视演职员圈
邮费	邮政资费
财校	财政学校
优属	优待军属和烈属
健检	健康检查
空管史	空中交通管理史
刑科	刑事检察科
公游	公费旅游
屠犹	屠杀犹太人
警特	警察特务
三军医大	第三军医大学
举协	举重协会
专干	专职干部
复退办	复员退伍军人安置办公室
医管局	医疗管理局
铁一局	铁道部第一工程局
国际中学生体联	国际中学生体育联合会
节电办	节电办公室
食研所	食品工业研究所
妇保	妇女儿童保护
夏征	夏季征收
美联处	美国驻北京联络处
私企协	私营企业协会
森铁	森林小铁路
林学会	林业学会
增产	增加产量
增编	增加编制
擅设	擅自设置
二战	二次大战
柬邀	请柬邀请
停运	停止运输
编采	编辑采访
警厅	警察厅
项目财务预测	项目财务指标预测
从政	从事政务
运输工联	运输工人联合会
警力	警务力量
匈通社	匈牙利通讯社
金权	金融方面的权力
羽球	羽毛球
查处	审查处理
信保	信用保证
揽储	招揽储蓄
中航	中国民航
肃贿	肃清贿赂现象
完小	完全小学
免验	免于检验
长话局	长途电话局
生化厂	生物化学制药厂
城管办	城市管理办公室
川妹	四川妹子
林管局	林业管理局
船管组	船只管理组
青少部	青少年部
高铁	高速铁路
中唱社	中国唱片社
孤幼	孤儿幼童
户证科	户籍证明科
催票	催促投票
人行	中国人民银行
农建队	农民建筑队
扩权	扩大自主权
厨卫	厨房卫生
债息	债券利息
附院	附属医院
暂编	暂时编制
社署	香港社会福利署
楼市	楼房买卖市场
纪检办	纪律检查办公室
海测	海洋测量
天大	天津大学
史语所	历史语言研究所
直航	直接航行
克军	克罗地亚军队
干管	干线管道
空基	空中基地
女足	女子足球
老弱病残幼	老年人体弱者病人残疾人幼儿
轻工	轻工业
反帝反修	反对帝国主义反对修正主义
壮盛	雄壮盛大
职代会	职工代表大会
农房	农民住房
空运站	香港航空货运站
肺心病	肺原性心脏病
共军	共产党的军队
南农大	南京农业大学
环发大会	联合国环境与发展大会
巡讲	巡回演讲
广播影视部	中华人民共和国广播电影电视部
纪委	纪律检查委员会
经保处	经济保卫处
七建	第七建筑公司
电贴	电力补贴
仿冒	仿制假冒
迫迁	强迫搬迁
组工会	组织工作会
夏洽会	夏季洽谈会
市农	城市和农村
农牧渔机	农业牧业渔业机械
日化所	日用化工研究所
亚裔	亚洲人后裔
退管会	退休职工管理委员会
推介	推荐介绍
骑游	骑自行车旅游
封资修	封建主义资本主义修正主义
农保	农村医疗保险
候判	等候法庭判决
米毒	米开朗基罗病毒
撤并	撤销合并
知青办	上山下乡知识青年办公室
语训	语言训练
停赛	停止比赛
临商	临时经商
直供	直接供应
揭批	揭发和批判
核加固	抗核加固
联防	治安联合防治
侵越	人侵越南
中大	中山大学
农会	农民协会
侦悉	侦察获悉
育林	培育森林
时空	时间和空间
演局	香港演艺发展局
民协	香港民主民生协进会
鄱湖	鄱阳湖
松嫩	松花江嫩江
涉案	涉及案件
巴统	巴黎统筹委员会
校建	学校建设
排列图	主次因素排列图
祖国战线	祖国统一民主主义战线
军政警宪	军队政府警察宪兵
彝医	彝族医学
尊干爱群	尊敬干部爱护群众
贸工	贸易和工业
中国儿艺	中国福利会儿童艺术剧院
数图网	数字图书网
治黄	治理黄河
人大	人民代表大会
特纵	特别纵队
清债	清理债务
治劣	治理劣质产品
限水	限制用水
雪联	滑雪联合会
上感	上呼吸道感染
节假	节日假日
国家科委	国家科学技术委员会
原辅	原料辅料
查办	检查办理
战干团	战时青年干部训练团
工贸商	工业贸易和商业
计息	计算利息
友促会	国际友谊促进会
鞍建	鞍山建筑
瑞郎	瑞士法郎
化轻	化学轻工业
二商	第二商业
台星	台湾电影电视明星
污源	污染源
直升考	直接升学考试
间选	间接选举
国际路联	国际道路联合会
准播	准许播放
转体	转换体制
县社	县和人民公社
专储粮	专项储备粮
中国作协	中国作家协会
中农信公司	中国农业发展信托投资公司
长服金	香港长期服务金
涉政	涉及政治
申办	申请办理
航图	航空图
森经局	森林经济管理局
中发行	中国发展银行
产销	生产和销售
劳动资源	劳动力资源
二毛	第二毛纺织厂
办结率	办理并了结的比率
高工专	高等工程专科学校
财委会	财政委员会
审委会	审查委员会
财贸办	财政贸易办公室
外研社	外国语言研究社
乒球	乒乓球
航校	航空学校
班代	班级成员代表
核反应堆	原子核裂变反应堆
稽查委	稽查委员会
妇联办	妇女联合会办公室
中统	国民党中央执行委员会调查统计局
火电煤	火力电力和煤炭
安检区	安全检查区
海监局	海上安全监督局
上工大	上海工业大会
川府	四川政府
冬奥会	冬季奥林匹克运动会
交运会	交通及运输委员会
电信	邮电通信
上海交大	上海交通大学
地下工委	地下工作委员会
民警	人民警察
市运会	市运动会
科研所	科学技术研究所
昆丑	昆曲丑角
驾训班	汽车驾驶训练班
义教	义务教育
商贸	商业贸易
检具	产品检验用具
自保	自我保护
北科影	北京科学教育电影制片厂
粮市	粮食市场
增税	增加税收
编播	编辑播音
51中	第51中学
人流	人工流产
农监办	农民负担监督办公室
农经办	农业经济办公室
女高师	女子高等师范学校
丝绸公司	丝绸工业公司
转包	转让承包
汽渡	汽车轮渡
中招办	高级中等学校招生办公室
女中	女子中学
类号	分类配号
财办	财贸办公室
加护	加强护理
亚剑联	亚洲击剑联合会
交管站	交通管理检查站
上访办	上访办公室
打援	打击敌方增援部队
西航	西北航空公司
会统	会计统计
教科文卫委	教育科学文化卫生委员会
扬大	扬州大学
防疫	防止瘟疫
新研所	新闻研究所
合拍	联合拍摄
投运	投入运行
外长	外交部长
公休日	公共休假日
扶贫办	扶持贫困地区办公室
国际体联	国际体操联合会
43中	第43中学
政经文史	政治经济文学历史
地委	中国共产党地区委员会
打假保优	打击制售假冒伪劣商品保护优质名牌商品
暗袭	暗中突袭
清退	清理并辞退
保监处	保险业监理处
南黎	南黎巴嫩
团代会	共青团代表大会
节能	节约能源
中石化	中国石油化学工业总公司
加姐	加拿大小姐
质检	质量检验
朝中社	朝鲜中央通讯社
路风办	路风整顾办公室
建施	建设实施
关重	关心重视
反右倾	反对右倾机会主义
军购	军备购买
音像	录音带和录像带
期指	恒生期货指数
券商	证券商
一医大	第一军医大学
考规	考试规则
党政工团	党组织行政部门工会组织团组织
金马	金门岛和马祖岛
黄陵	黄帝陵
控购	控制购买
建模	建立模型
货源	货物来源
特体	特殊形体
水环监	水利环境监测
华北区	华北行政区
县委	中国共产党县委员会
舞院	舞蹈学院
亚太经社会	联合国亚洲和太平洋经济社会委员会
医管会	医院管理学会
综保	综合保险
温婉	温和委婉
林管所	林业管理研究所
邮路	邮递路线
菲航	菲律宾航空公司
纪检组	纪律检查组
汽摩	汽车摩托车
深指	深圳股票指数
先代会	先进分子代表大会
主控	主要控制
农经	农业经济
协查	协同侦查
避税港	国际避税港
达标	达到规定的标准
女车	女式自行车
迁建	迁址建设
归侨	归国华侨
救灾办	救灾办公室
空驶	空车行驶
农技站	农业技术推广站
彩照	彩色照片
海铁联运	海上和铁路联营运输
林牧渔	林业牧业渔业
广管局	香港广播事务管理局
刊播	刊登和广播
中委会	中央委员会
战动会	战地总动员委员会
党报	中国共产党机关报
孔墨	孔子和墨子
书画	书法和绘画
捐资	捐助资金
机检	计算机检索
市场办	市场办公室
管修站	管理维修站
和洽	和睦融洽
崇美	推崇美国
办结	办理并了结
速测	快速检测
林院	林学院
采编播	采访编辑和播音
冬炼	冬季体育锻炼
政法办	政法委员会办公室
少代会	中国少年儿童先锋队代表大会
外经处	对外经济贸易处
辟建	开辟建设
少教人员	少年收容教养人员
全国体总	中华全国体育总会
津大	天津大学
法专	法律专科学校
倡行	提倡推行
葡共体	葡语国家共同体
医工院	医药工业研究院
承委会	承办委员会
领海权	领海主权
竹艺	竹制品工艺
高检	最高人民检察院
柔锦赛	柔道锦标赛
民改	民主改革
医大	医科大学
纺织部	纺织工业部
花协	花卉协会
房贴	住房补贴
转知	转发通知
美展	美术作品展览
究办	追究惩办
司干	司局级干部
防指	防汛抗旱指挥部
开行	开发银行
合演	合作演出
民科	民办科技
港口费	港口使用费
海基会	海峡交流基金会
城八区	城市八个区
一野	中办民解放军第一野战军
库管员	仓库保管员
防尘	防止灰尘
非常人大	非常人民代表大会
建科院	建筑科学研究院
文康司	香港文娱康乐广播司
防杜	防止与杜绝
党政军企	党组织政府部门军队企业
特支费	特殊开支费
少儿馆	少年儿童馆
广电界	广播电影电视界
打的	打的士
治淮	治理淮河
国际橇联	国际有舵雪橇和平底雪橇联合会
丙球	丙/Mg 种球蛋白
尊师爱生	尊敬教师爱护学生
大教联	大学教授联谊会
支薪	支领薪水
农业社	农业生产合作社
副流感	副流行性感冒
果蔬	水果和蔬菜
邮司	邮票公司
排危	排除危险
乐评	音乐评论
中财部	中央政府财政部
货管	货物运输管理
导因	导致的原因
首试	首先考试
国投	国际信托投资公司
政教	政治和宗教
冶制	冶炼制造
飞运	飞机运输
港管处	港口专用码头管理处
华视	中华电视台
审校	审阅校对
电信局	电信管理局
施压	施加压力
滞洪办	滞洪办公室
供片	供应影片
农工	农业和工业
个体劳协	个体劳动者协会
农运会	农民体育运动会
男曲	男子曲棍球
支书	支部书记
男乒赛	男子乒乓球比赛
刘邓	刘少奇邓小平
台蕉	台湾香蕉
院校	学院和学校
纠弹	纠举弹劾
省中	省立中学
农林牧渔	农业林业牧业渔业
结防	结核病防治
供需	供应和需求
职初	职业初中
国家教委	国家教育委员会
收废	收废品
电网	电力网
包钢	包头钢铁公司
地大	地质大学
民舞	民族舞蹈
教改	教学改革
水气卫	水煤气卫生
税警	税务警察
免修	免予修业
集体合同	集体劳动合同
参品	参赛作品
外存	外部存储器
深电集团	深圳电子集团公司
速查法	快速查找法
汽配	汽车配件
兰洽会	兰州洽谈会
批斗	批判并斗争
教风	教学学风
互赖性	互相依赖性
报协	报业协会
晨运	清晨运动
全国少工委	全国少年先锋队工作委员会
筹委	筹备委员会委员
手外科	手术外科
民俗	民间风俗
吐纳	吐故纳新
编委会	编纂委员会
流乞	流浪乞讨
股本	股份资本
行业办	行业办会室
语委	语言文字工作委员会
股交所	股票交易所
工厦	工业大厦
融资	融通资金
音代会	音乐家代表大会
腰穿	腰椎穿刺
科普记协	科普记者编辑协会
世乒赛	世界乒乓球锦标赛
长话点	长途直拨电话营业点
炒票	炒买炒卖票证
广远公司	广州远洋运输公司
女知联	女知识分子联谊会
代训	代替训练
低浅	低下肤浅
北大	北京大学
机修	机械修理
综采队	综合机械化采煤队
市值	市场价值
景瓷	景德镇瓷器
血检	血液检测
果品办	果品办公室
家福会	香港家庭福利会
德才	品德和才能
女排	女子排球
欧锦赛	欧洲足球锦标赛
设限	设置界限
珠峰	珠穆朗玛峰
残奥会	残疾人奥林匹克运动会
时评	时事评论
省博	省博物馆
鼓勇	鼓足勇气
军医大	军事医科大学
基金委	基金委员会
东大	东北大学
惩暴	惩罚暴力
文教	文化教育
乡企转制	乡镇企业转制
主秘	主任秘书
氧割	氧气切割
人动会	中国人民抗日动员委员会
薪津	薪金津贴
物校	物资学校
中福会	中国福利会
社维法	台湾社会秩序维护法
热作所	热带作物研究所
集管局	集体企业管理局
省行	省级银行
纪评会	纪律部队评议会
贴水	远期贴水
女排赛	女子排球锦标赛
企经委	企业经济委员会
蒋军	国民党蒋介石军队
矿警	矿山警察
维权	维护合法权益
阿拉伯工联	阿拉伯工人会国际联合会
上视	上海电视台
民康署	香港民康执行总署
批供	批量供应
中企协	中国企业管理协会
客运	旅客运输
工联	工联会
紧控	紧俏和控制
文编室	文学编辑室
光电所	光电技术研究所
中远	中国远洋运输总公司
载机	运载飞机
赌资	赌博的资金
中国林科院	中国林业科学院
选美	竞选美女
中点	中式点心
赶超	赶上并超过
大巴	大型巴士
政校	政治学校
蒙交会	中国内蒙古经济贸易交易会
政教处	政治教育处
持股	持有股票
商贸联委会	商务贸易联合委员会
巡展	巡回展出
曲协	曲艺工作者协会
军干校	军人干部学校
送办	移送法办
体卫司	体育卫生司
体校	体育学校
职监员	职工物价监督员
安钢	安阳钢铁公司
伏疗	伏天治疗
直快	直通旅客快车
金饰	黄金首饰
中职	中级职称
卷款	卷走现款
阿航	阿根廷航空公司
计生户	计划生育户
保优打劣	保护优质的打击劣质的
职安	职业安全健康
比学赶帮超	比先进学先进赶先进帮后进超先进
箱管	国际集装箱管理
免疫	免疫性
防贪	防止贪污
商团	商界业务代表团
篮联	篮球联合会
佛联	佛教徒联谊会
步校	步兵学校
商中	商业中学
少教所	少年管教所
奥项	奥运会项目
党政办	党政办公室
资审	资信审查
文教科卫	文化教育科技卫生
桥艺	桥牌艺术
城管委	城市管理委员会
业体校	业余体育运动学校
展布	展示公布
贮运	贮藏和运输
克旗	克什克腾旗
亚青赛	亚洲青年锦标赛
剧协	戏剧家协会
港澳台侨	香港澳门台湾华侨
经贸会	经济贸易会议
叉鸡饭	叉烧鸡肉饭
物业办	物业办公室
亚太经贸	亚洲太平洋经济贸易
计发	计算与发放
坑探	坑探工程
捉凶	捉拿凶犯
内参片	内部参考影片
校纪	学校纪律
中广	台湾中国广播公司
祖统委	全国政协祖国统一联谊委员会
影视处	香港影视及娱乐事务管理处
特教	特殊教育
侨代会	全国归国华侨代表大会
党纪	党的纪律
参政	参与政务
考纪会	考纪委员会
农电	农村用电
国际羽联	国际羽毛球联合会
税率	税收的比率
外刊	境外期刊
加挂	增加挂牌
马联	赛马联合会
金交所	金融交易所
侗民	侗族人民
助益	帮助和益处
城运会	城市运动会
高考	高等学校统一招生考试
娱记	娱乐新闻记者
开展	开始展览
大三生	大学三年级学生
中影	中国电影
汪伪	汪精卫伪国民政府
自建	自行建造
助检员	助理检察员
组宣部	组织宣传部
药监	药品监督
工艺过程	工艺技术过程
亚洲泳联	亚洲业余游泳联合会
联放	联合放款
超模	超级模特
购藏	收购收藏
拨交	拨出交到
二十中	第二十中学
内斗	内部争斗
央行	中央银行
女小	女子小学
接访	接待上访
消大	消防大队
巴解组织	巴勒斯坦解放组织
私印	私人姓名印
干训队	干部集训队
测温	测量温度
计财司	计划财务司
戏改	戏剧改革
中石油	中国石油公司
塑膜	塑料薄膜
炮校	炮兵学校
库容	水库蓄水容积
亚太邮联	亚洲太平洋邮政联盟
增删	增加和删除
温善	温和善良
北科大	北京科技大学
粮交会	粮食交易会
外报	境外报纸
南队	南斯拉夫队
乡邮	乡村邮递
党政工	党组织行政部门工会组织
哈交会	哈尔滨物资交流会
协调办	协调办公室
搜爆	搜查爆炸物品
塑瓶	塑料瓶
新民党	新民主联合党
老死	衰老死亡
联柬机构	联合国驻柬埔寨临时权力机构
农副工	农业副业工业
静息	安静休息
冰期	冰川时期
打私	打击走私活动
标贴	商标招贴
管城	管理城市
东协	东南亚国家协会
共荣	共同繁荣
运控	运输控制
模工	人体模特工
记联	中国左翼新闻记者联盟
环保	环境保护
台盟	台湾民主自治同盟
刑二庭	刑事二庭
名优特新	名牌产品优质产品特产产品新品
一轻	第一轻工业局
城雕委	城市雕塑委员会
女青	香港基督教女青年会
艰困	艰难困苦
亚作盟	亚洲作曲家同盟
农广校	农业广播电视学校
女俘	女性俘虏
业大	业余大学
临屋	临时房屋
铁二局	铁道部第二工程局
中博	中央博物院
中直政治部	中央直属机关政治部
机损	机械损坏
战训	战备训练
豪宅	豪华住宅
林管站	林业管理站
亚乒联	亚洲乒乓球联合会
服研所	服装研究所
浸院	香港浸会学院
采运销	采摘运输销售
拒签	拒绝办理签证手续
户政	户籍政策
同比	同期相比
高教工委	高等教育工作委员会
反腐办	反对腐败办公室
尊师	尊敬老师
开拍	开始拍摄
职先学校	职业先修学校
盲辅会	香港盲人辅导会
医办室	医生办公室
研判	研究判断
行人专区	行人专用区
协拍	协助拍摄
清华	清华大学
农八师	新疆生产建设兵团农八师
海警支队	海上武装警察支队
萧影	萧湘电影制片厂
国新社	国际新闻社
五一节	五一国际劳动节
农高会	农业高新科技成果博览会
外事	外交事务
外经	对外经济
长城公司	中国长城工业公司
教协	香港教育专业人员协会
解教人员	解除劳动教养人员
扩版	扩大版面
军仪	军人仪表
弹速	子弹速度
准购	批准购买
五交	五金交电
教参片	教学参考影片
外文局	外文出版发行事业局
地税	地方税务
调减	调整和减少
台商	台湾商人
尼铁	尼日利亚铁路公司
港胞	香港同胞
正副	正职和副职
群防科	群众防病治病科
海贝类	海产贝壳类
冻分割肉	冷冻分割肉
土规局	土地规划局
交长	交通部长
粮划署	粮食规划署
社劳青	社会主义劳动青年同盟
存续	存在延续
货邮	货物邮件
协委会	协调委员会
税政	税收政策
亚洲箭联	亚洲射箭联合会
食品办	食品工业办公室
青工	青年工人
院校所	学院学校研究所
机收	机械收割
老干办	老干部办公室
公检法	公安机关检察院和法院
星战	星球大战
法学所	法学研究所
科国	科威特国
军援	军事援助
中关工委	中国关心下一代工作委员会
水科院	水利水电科学研究院
对外经贸大	对外经济贸易大学
日资	日本资本
铁中	铁路中学
质控	质量控制
北美馆	台北市美术馆
脱产	脱离生产
自由身	自由职业身份
摩步	摩托化步兵
国标化	国际标准化
计生	计划生育
托派	托洛茨基派
转风	转变作风
公教	公务和教学
通膨	通货膨胀
胶化	胶体化学
特刑庭	特种刑事法庭
十二所	第十二所
尿感	尿路感染
欧币	欧洲国家货币
世青节	世界青年联欢节
上柴	上海柴油机厂
导购	引导购物
立交桥	立体交叉通行的桥梁
校董	学校董事会董事
俄联邦	俄罗斯联邦
私铁	私营铁路公司
货客	货物旅客
供市	供应市场
童星	儿童电影明星
检审	检验和审查
过实	超过实际
智龄	智力年龄
施才	施展才能
体语	身体语言
采编	采访编辑
特奥会	特殊奥林匹克运动会
孔教	孔子教育
测控	监测控制
轮值	轮流值班
锦化	锦州化工
质检处	质量检验处
物耗	物资消耗
快锻机	快锻液压机
先心病	先天性心血管病
新影	中央新闻纪录电影制片厂
强检	强行检查
凌虐	凌辱与虐待
特使	特命全权大使
贸发局	香港贸易发展局
钢混	钢筋混凝土
冰协	冰球协会
兵暴	士兵暴动
酌出	酌量卖出
婚检	婚前身体检查
化纺	化学纤维纺织
根雕	树根雕刻
国家经委	国家经济委员会
美共	美国共产党
贸洽会	贸易洽谈会
亚乒联盟	亚洲乒乓球联盟
西战团	西北战地服务团
待青	待业青年
女花	女子花剑
工办	工业办公室
性变	性别变化
绿带	绿化地带
抗美援越	抗击美国侵略援助越南人民
驾照	驾驶执照
冬交会	冬季交易会
港大	香港大学
苏锡常	苏州无锡常州
铁检	铁路运输检察院
油国组织	石油输出国组织
群艺馆	群众艺术馆
退管	退休职工管理
歌星	歌唱明星
社团办	社团办公室
建章	建立规章
海图	航海用图
彩涂	彩色涂料
非行	非洲开发银行
中国书协	中国书画家协会
中东社	中东通讯社
预提税	预提所得税
竞体	竞技体育
高公局	高速公路管理局
化危品	化学危险品
赞服	赞扬佩服
卫校	卫生学校
农副工商	农业副业工业和商业
世羽赛	世界羽毛球锦标赛
农建局	农业建设局
老龄委	老龄工作委员会
脱权	脱离权力
传染病	可传染性疾病
金商	黄金经营商
立局	立法局
城运村	城市运动会运动员村
环发	环境与发展
经果林	经济果品林
国合	国营商业和供销合作社
科工贸	科技工业和贸易
疠气	疫疠之气
老少边穷	革命老区少数民族地区边境地区穷困地区
俄专	俄文专科学校
驱护舰	驱逐护卫舰
精神消费	精神生活消费
农技协	农业技术协会
施救	实施抢救
医患	医生患者
空政	空军政治部
盒带	盒式录音带
蓄婢	蓄养婢女
男中	男子中学
环科所	环境科学研究所
政工组	政治工作组
推察	推测考察
竞叫	竞相叫价
数传	数字传送
节资	节约资金
民委	民族事务委员会
南空	南京军区空军部队
老山边穷	革命老区山区边境地区穷困地区
动检	动物检疫
列检	列车检查
石化	石油化工
卫护	捍卫保护
民谚	民间谚语
影人	电影界人士
知青	知识青年
省防指	省防汛指挥部
激光所	激光技术研究所
意航	意大利航空公司
副主委	副主任委员
劳顾会	劳资顾问委员会
理工	理工科
综防	综合防治
国家语委	国家语言文字工作委员会
特准	特别准许
群防	群众参与预防
洽议	洽谈商议
储保热	储蓄保险热
国际曲联	国际曲棍联
文艺界	文学艺术界
减让	减税让利
建专	高等建筑专科学校
全民企业	全民所有制企业
农职高	农业职业高中
交管部门	交通管理部门
市郊	市区和郊区
北农大	北京农业大学
严罚	严肃处罚
自动化院	自动化研究院
工博会	工业博览会
放私	放纵走私
民曲	民间乐曲
戏工室	戏剧工作室
特检站	经济特区检查站
腰麻	腰椎穿刺麻酸
无人机	无人驾驶飞机
面商	当面商谈
亚排联	亚洲排球联合会
农地	农业用地
漏检	遗漏未检验
声韵	声母韵母
港航	港口和航运部门
民调	民意调查
书展	书法作品展览
名优特	名牌产品优质产品特产产品
工专	工业专科学校
外军部	外国军事研究部
扩销	扩大销售
技检	技术检查
军保委	军事设施保护委员会
深弹	深水炸弹
权保会	权益保障会
海模	航海模型
中电进出口公司	中国电线电缆进出口联营公司
能耗	能源消耗
乌铁局	乌鲁木齐铁路局
沈后	沈阳军区后勤部
川大	四川大学
理化	物理和化学
男花	男子花剑
台统协	台湾中国和平统一协会
廉政	廉洁勤政
民困	民生困难
初产妇	初次生产的妇女
港客	香港客商
物探	地球物理勘探
影带	录影带
影评会	电影评论协会
文体广电局	文化体育广播电视局
欧共体执委会	欧洲共同体执行委员会
手协	手球协会
百白破	百日咳白喉破伤风
职教办	职业教育办公室
警员	警务人员
社科	社会科学
中导	中程导弹
交警	交通警察
外秘会谈	外交秘书级会谈
老中青	老年中年和青年
中招	高级中等学校招生
妇援会	香港妇女求援基金会
随访	随同访问
议联	议员联盟
川菜	四川菜系
食化	食品化验
药植所	药用植物资源开发研究所
反猎	反对狩猎
院纪	学院纪律
示爱	表示情爱
采供	采购供应
名模	著名模特儿
暑运	暑期旅客运输
兰铁	兰州铁路
质管员	质量管理员
内销	国内销售
支重办	支援重点建设办公室
融政	金融政治
转工	转为工人身份
太钢	太原钢铁公司
优长	优点和长处
特侦站	特别侦察站
女双	女子双打
中函	中等学校函授
清墓办	清理墓葬领导小组办公室
内转外	内销转外销
通胀	通货膨胀
尖东	香港尖沙咀东部
土共	土耳其共产党
巴民阵	解放巴勒斯坦民主阵线
铁海联运	铁路和海路联合运输
工资系数	工资等级系数
旋耕机	旋转耕耘机
森防	森林防护
免刑	免予刑事处分
幼联	香港幼儿教育服务联会
收案	收受案件
加榴炮	加农榴弹炮
加幅	增加幅度
产运销用	生产运输销售使用
音教委	音乐教育委员会
亚帆联	亚洲帆船帆板联合会
奥星	奥林匹克希望之星
特视效果	特别视觉效果
中试	中间试验
优特钢	优质特种钢
展厅	展览大厅
女工部	妇女工作部
农运	农民运动
遵纪爱民	遵守纪律爱护人民
医工	医务工作者
战训科	作战训练科
艺校	艺术学校
工企	工业企业
影机	电影放映机
农化	农业化学
北拉	北方话拉丁新文字
微录机	微型录音机
航博	中国航空博物馆
军属	现役军人家属
治保会	治安保卫委员会
林校	林业学校
责编	责任编辑
规制	规章制度
社保	社会养老保险
波海	波罗地亚海
泰佣	泰国籍的佣工
质保书	质量保证书
钢院	钢铁学院
航联	航空联合会
俄队	俄国家队
损减	损失减少
中国美协	中国美术家协会
公厕	公共厕所
劳审处	香港劳资审裁处
打扒	打击扒手
文史哲	文学史学哲学
六盘水矿区	六枝盘江水城矿区
批建	批准建设
声控	声音控制
传媒	传播媒介
湿控	湿度控制
燕化	燕山石油化学工业公司
国际射联	国际射击联盟
拨改贷	拨款改为贷款
自筹投资	自筹基建投资
肃毒	肃清吸毒现象
电挂	电报挂号
科代会议	科学工作者代表会议
侨务处	华侨事务处
支铁办	支援铁路建设办公室
农林厅	农业林业厅
地学	地球科学
同劳同酬	相同的劳动相同的报酬
上昆	上海昆剧团
乔灌草结合	乔木灌木和草带结合
电检科	电讯检查科
教辅	教学辅导
尸检	尸体病理检查
监卸	监督卸货
苏区	苏维埃区域
劳联	劳工联合会
政工部	政治工作部
研商	研究协商
毛著	毛泽东著作
待学	等待入学
统建统分	统一建设和统一分配
市百	市百货公司
化探	化学勘探
体总	中华全国体育总会
青委	青年工作委员会
傣医	傣族医学
赶杀	赶尽杀绝
军需所	军需装备研究所
航务	航行事务
刑庭	刑事法庭
房展	住房展览
断交	断绝外交关系
尤杯赛	尤伯杯赛
人保	中国人民保险公司
程控	程序控制
揭批查	揭发批判和清查
火险等级	森林火灾危险等级
保洁制	保持清洁的制度
中国科协	中国科学技术协会
女超	女子超级
技考委	技术考核委员会
普采	普通机械化采煤
南华会	香港南华体育会
半导体	半导体收音机
地球所	地球物理研究所
画展	绘画作品展览
安检门	安全检查门
私财	私人财产
亚网联	亚洲网球联合会
磨耗	磨损消耗
动迁	动员搬迁
美帝	美国帝国主义
储训	储备训练
中外合资	中方与外方联合投资
农金	农村金融
廉宜	低廉适宜
教改会	教育改革委员会
台塑集团	台湾塑胶集团
棉站	棉花收购站
共享税	中央和地方共享税
蔬果	蔬菜水果
协捕	协助追捕
巴航	巴基斯坦航空公司
长委	长江水利委员会
乙肝	乙型病毒性肝性
加刑	加处徒刑
普工	普通工人
苏杭	苏州和杭州
女足赛	女子足球比赛
新地	新鸿基地产
汽拖	汽车和拖拉机
公交法	公平交易法
港监	港务监督
高教委	高等教育委员会
空距	空中距离
中医大	中国医科大学
摘介	摘要介绍
官兵	军官和士兵
裁委会	裁判委员会
植棉	种植棉花
整改	整顿改进
拳协	拳击协会
临委会	临时委员会
南工	南京工学院
文管司	文字应用管理司
农军	农民自卫军
地矿	地质矿产
特稿	特写稿件
生技办	生产技术办公室
清估	清理和估算
城院	城市建设学院
八五	第八个五年
陈粟	陈毅粟裕
根艺	根雕艺术
采编印	采访编辑印刷
交检站	交通管理检查站
同工同酬	同样工作同等报酬
帮贫	帮助贫困户
教研员	教学研究员
基教司	基础教育司
摄制	拍摄制作
高一	高级中学一年级
倒汇	倒买倒卖外汇
外银	外资银行
复关	恢复关贸总协定缔约国地位
宝钢	宝山钢铁集团
随防	随时防治
马新社	马来西亚新华社
直罗	直条罗纹
历博	中国历史博物馆
长三乙	长征三号乙
掌珠	掌上明珠
中客	中型客车
科教片	科学教育影片
一大	第一次全国代表大会
博导	博士生导师
东北抗联	东北抗日联军
动效	动作效果
邮掮	邮票掮客
余资	剩余资金
男女队	男打和女队
万体馆	万人体育馆
棚改	棚屋改造
贸工农	贸易和工业农业
量贩商	批量贩卖商
机器人所	机器人研究所
英航	英国航空公司
精铸厂	精密铸造厂
长轮公司	长江轮船总公司
东北剿总	东北剿匪总司令部
护产	保护财产
外币	外国货币
国际棋联	国际象棋联合会
锦棉袜	锦棉混纺袜
南共	南斯拉夫共产党
定岗	确定工作岗位
总枢纽	总通信枢纽
农用电	农业用电
棒喝	当头棒喝
人武	人民武装
联署	联合署名
摄美部	摄影美术部
支委	支部委员会委员
手联	手球联合会
水警	水上警察
中国残联	中国残疾人联合会
一秘	一等秘书
解恐	解除恐惧
承译	承担翻译
乡医	乡村医学
签约	签订契约
空模	航空模型
青军会	青年军人联合会
洗化总汇	洗涤化妆品总汇
宣教	宣传教育
欧空局	欧洲空间局
扩繁	扩大繁育
内资	国内资本
近物所	近代物理研究所
施袭	实施袭击
续演	继续演出
妇检室	妇科检查室
续展	继续展览
布控	布置控制
村代会	村民代表大会
卫福政策	卫生福利政策
护校	护士学校
教卫	教育和卫生
聋童	耳聋儿童
男团	男子团队
八卦掌	游身八卦掌
中野	中原野战军
决分	决算分配
结案	结束案件
参展演	参加展览或演出
港商	香港商人
植物所	植物研究所
中联部	中国共产党对外联络部
分委	分委会
车配	车辆配件
世博园	世界艺术博览园
文卫体	文化卫生体育
超龄	超过规定年龄
民联	三民主义同志联合会
控烟	控制烟尘
平挂	平信和挂号信
农林水	农业林业水利
陆航团	陆军航空兵团
热工学	热能工程学
中巴	中型巴士
城化联	中国城市化学工业联合会
环保署	环境保护署
泳队	游泳队
参委	参事委员会
巴盟	内蒙古自治区巴彦淖尔盟
导游女	导游女郎
刑辩	刑事辩护
电感	电子感应
教科文组织	联合国教育科学及文化组织
企改办	企业综合改革办公室
民包	民用包裹
西语	西班牙语
橡塑品	橡胶塑料制品
县干	县级干部
联试	联合试验
争办	争取承办
物回公司	物资回收公司
国商	国际商业信贷银行
中包总公司	中国包装总公司
青记	中国青年新闻记者学会
医卫	医疗卫生
省建公司	省建筑工程公司
畅旺	畅销兴旺
冶金所	冶金研究所
市标	市里颁布的标准
自控力	自我控制力
技工贸	技术工业生产和贸易
小四轮	小四轮拖拉机
外委	外事委员会
清财	清理财产
智商	智力商数
侦办	侦察办公室
控申处	控告申诉处
计算所	计算机技术研究所
限产压库	限量生产压缩库存
土肥所	土壤肥料研究所
炮指	炮兵指挥部
评标委	评标委员会
空调	空气调节
超常	超过常规
学则	学生守则
妇救会	妇女救国会
康雍	康熙和雍正
损农	损害农民利益
国际自由工联	国际自由工会联合会
爱委会	爱国卫生运动委员会
普外科	普通外科
审评	审查评议
女教所	女子劳动教养管理所
节汇	节约外汇
主因	主要原因
计财处	计划财务处
奖助	奖励和赞助
体卫艺司	体育卫生艺术司
彩卷	彩色胶卷
环情	环境情况
精防院	精神病防治医院
师友	老师和朋友
担正	担任正角色
文电	文函电讯
25中	第25中学
老区办	老区办公室
化物	化学物理
春训	春季训练
提案委	提案委员会
公捕	公开逮捕
共保	共同保护
毒副	毒品副作用
外债	外国债务
城贸	城市贸易
职棒球员	职业棒球队员
东北局	中国共产党中央委员会东北局
党政军警民	党组织政府部门军队警察民众团体
外需	外部需求
进销差	进销差价
全国科联	中华全国自然科学专门学会联合会
公映	公开放映
航线	航空线
收支存放	收入支出存款发放贷款
迁校	迁移学校
上总	上海市总工会
临快	临时快车
廉政办	廉政办公室
金属所	金属研究所
苏绣	苏州刺绣
普师	普通师范
党团	党组织团组织
67中	第67中学
书艺	书法艺术
日陶厂	日用陶瓷厂
积案	积压的案件
群团	群众性团体
外调	向外调运
色织	有色纺织
重汽	重庆汽车制造厂
高智	高智商
秦汉唐	秦朝汉朝唐朝
奥邮展	奥林匹克邮票展览
世经所	世界经济研究所
四轧钢	第四轧钢厂
弱奥会	弱智人奥林匹克运动会
药械科	药品器械科
作联	香港作家联谊会
老弱病残孕幼	老年人体弱者病人残疾人孕妇幼儿
黄患	黄河洪水灾患
城郊	城市郊区
创委会	创作委员会
视保屏	视力保护屏
中印公司	中国印刷公司
市府办	市政府办公室
卫视	香港卫星电视有限公司
七纵	第七纵队
中科	中国科学院
暂取	暂时录取
公平会	公平交易委员会
船模	舰船模型
小语会	小学语文教学研究会
电子科大	电子科技大学
轻工部	中华人民共和国轻工业部
权责利	权力责任利益
台客	台湾旅客
律联	律师联盟
亚通组织	亚洲太平洋通讯社组织
限亏增盈	限制亏损增加盈利
武工队	敌后武装工作队
受援	接受援助
香港指数	香港股价指数
扩广	扩大推广
访京团	访问北京的代表团
奥奖片	获奥斯卡奖影片
县人大	县人民代表大会
建工	建筑工程
上交会	上海商品交易会
北空后	北京军区空军后勤部
深大	深圳大学
生资站	生产资料站
中汽联	中国汽车工业联合会
地矿部	地质矿产部
西安交大	西安交通大学
乔灌草	乔木灌木草带
全教会	全国教育工作会议
农救	农民救国会
针距	针迹距离
轮战	轮流参加战斗
收汇	收入外汇
足总	香港足球总会
流感	流行性感冒
中国杂协	中国杂技艺术家协会
逃票	逃避买票
伊阵	伊斯兰拯救阵线
反销税	反倾销税
耶教	耶稣教
村干	村级干部
爆膨	爆制膨化
海后	中国人民解放军海军后勤部
演艺界	表演艺术界
劳雇	劳工和雇主
化工公司	化学原料工业公司
招干	招聘干部
马盟	阿拉伯马格里布联盟
脱困办	脱困办公室
华交会	中国华东出口商品交易会
国际货约	国际铁路货物运送公约
督查	监督检查
体院	体育学院
亚广联	亚洲太平洋广播联盟
农改场	农业改良场
商办	商务办事处
考评	考核评议
海大	海南大学
计生办	计划生育办公室
奶管站	牛奶供应管理站
女垒	女子垒球
船保协会	中国船东互保协会
反战	反对战争
省队	省代表队
男篮	男子篮球
增招	增加招生
华杯赛	全国华罗庚金杯少年数学邀请赛
南通社	南斯拉夫通讯社
转岗	转换工作岗位
研发	研究开发
旅业	旅游业
国企	国有企业
杭州艺专	杭州艺术专科学校
名品	著名商品
刊大	刊授大学
人身险	人身保险
征期	征收期
男台	男子跳台跳水赛
盲协	盲人协会
初级社	初级农业生产合作社
总产	总产量
首规委	首都规划委员会
海委会	政府间海洋学委员会
中研院	国民党中央研究院
赔偿办	赔偿办公室
巴控区	巴基斯坦控制区
新训	新兵训练
质监站	质量监督联络站
墨城	墨西哥城
牧工商	牧业工业和商业
廉署	港督特派廉政专员公署
政工科	政治工作科
左联	中国左翼作家联盟
女乒赛	女子乒乓球比赛
尸解	尸体解剖
科教文卫体	科学教育文化卫生体育
公铁联运	公路铁路联合运输
台办	国务院台湾事务办公室
康乐	健康娱乐
外语系	外国语言文学系
抗救会	抗日救国会
货运	货物运输
经贸	经济贸易
会商	会谈商讨
少工委	中国少年先锋队全国工作委员会
声画	声音和画面
海院	航海学院
拉美	拉丁美洲
篮赛	篮球赛
黑工	黑市劳工
护厂	保护工厂
小型机	小型计算机
女编	女编辑
要角	重要角色
核电站	原子核能发电站
刑检厅	刑事检察厅
空压机	空气压缩机
针纺	针织纺织
亚田联	亚洲田径联合会
劳服	劳动服务
党政军警	党组织政府部门军队警察
担运队	担架运输队
自由工联	国际自由工会联合会
微雕	微型雕刻
外办	外事办公室
全休	全日休息
宣贯	宣传贯彻
二十五中	第二十五中学
中莎会	中国莎士比亚研究会
土管局	土地管理局
中老	中年老年
接待办	接待办公室
地心说	地球中心说
游憩	游玩与休憩
B超	B型超声诊断
劳大	全国劳动大会
朝侨	朝鲜侨民
主险	主要保险
等离子刀	等离子体手术刀
人教社	人民教育出版社
党建	党的建设
高检院	中华人民共和国最高人民检察院
助研	助理研究员
个唱	个人演唱会
批改	批阅和修改
市管处	市政工程管理处
家扶	家庭扶助
人口普查办	人口普查领导小组办公室
大一	大学一年级
统保	统一保险
冲扩	冲洗扩印
香港工联	香港工会联合会
世贸中心	世界贸易中心
空政文工团	空军政治部文艺工作团
心室纤颤	心室纤维性颤动
运递	运输和投递
科贸	科技和贸易
春运办	春节旅客运输办公室
社福	社会福利
炒金	炒卖黄金
邮总	中国人民邮政总局
仪化公司	江苏仪征化纤工业联合公司
二编室	第二编辑室
当值	当班值日
差旅	出差旅行
教院	教育学院
人险	人身保险
艺院	艺术学院
化武	化学武器
特考	特种考试
中国羽协	中国羽毛球协会
盒饭	盒装饭菜
安委办	安全生产委员会办公室
国际垒联	国际垒球联合会
节材	节约材料
古丝路	古代丝绸之路
初师	初级师范学校
伙委	伙食委员
运署	香港运输署
扶轮团	香港扶轮青年服务团
职专	职业中等专科学校
滑校	滑翔运动学校
军工	军事工业
证监会	中国证券监督管理委员会
自控	自我控制
领台	占领台湾
全委	全国委员会
流资	流动资金
华促会	华夏文化促进会
旅校	旅游职业学校
财贸	财政贸易
标准局	标准计量管理局
五城会	第五届城市运动会
信用联社	信用联合社
足协	足球协会
对台办	对台湾工作办公室
旱涝	旱灾和涝灾
科考	科学考察
地铁	地下铁路
厂办	厂长办公室
妇干	妇女干部
计征	计划征收
女曲	女子曲棍球队
文化局	文化事业管理局
乔峰	乔戈里峰
像带	录像带
摄录导	摄像录音导演
备耕	准备耕种
上海工联	上海工会联合会
认许	承认和默许
长三丙	长征三号丙/Mg
政圈	政治圈子
保监委	中国保险监督管理委员会
补税	补交税款
咳喘	咳嗽哮喘
马列学院	马克思列宁学院
棉织	棉纺织
外管办	外事管理办公室
残奥委	残疾人奥林匹克运动委员会
舰院	舰艇学院
农工旅	农业工业旅游
春招	春季招生
护法	维护临时约法
监察办	监察办公室
菌肥	细菌肥料
学用结合	学习和运用结合
经警	经济警察
统购统配	统一收购和统一配售
冬运	冬季运输
师徒	师傅和徒弟
赛风	比赛作风
手拖	手扶拖拉机
员额	人员数额
朝军	朝鲜军队
胶袋	塑胶袋
商住	经商者住宿
车险	汽车保险
汽配城	汽车配件城
高级社	高级农业生产合作社
成百	成都百货
黄毒	黄色毒素
联展	联合展览会
药监局	药品监督局
拖配厂	拖拉机配件厂
提拔	提取划拔
减薪	减少薪资
劳教	劳动教养
肃匪	肃清土匪
亚青足赛	亚洲青年足球赛
房颤	心房纤维性颤动
行署	行政公署
女大	延安中国女子大学
职高	职业高中
安外	安定门外
非劳动人口	非劳动年龄人口
教科文部	教育科学文化部
扫黑	扫除黑手党
农本	农业成本
环卫节	环境卫生工人节日
东视	上海东方电视台
夜业	夜间职业
明令	明确命令
审片	审查电影样片
观赛	观看比赛
农林委	农林委员会
国统矿	国家统配煤矿
长办	长江流域规划办公室
违建	违反规章制度的建筑
社团	社会组织和群众团体
高饶	高岗饶漱石
耗油	消耗汽油
教署	香港教育署
孕产	孕妇产妇
私学	私立学校
坑蒙	坑害蒙骗
截稿	截止投稿
学陶	学习陶行知
资产	资金财产
重机厂	重型机器厂
电算	电子计算
承租	承包租赁
征迁	征地搬迁
柳铁	柳洲铁路局
军警民	军人警察和人民
音带	录音磁带
年审	年度检审
国际制	国际单位制
房科所	住房科学研究所
转干	转为干部身份
春考	春季考试
修律	修订法律
站调	航站调度室
联系汇制	香港联系汇率制度
科工贸农	科技工业贸易和农业
毕分办	毕业分配办公室
侵朝	人侵朝鲜
剑校	击剑学校
上芭	上海芭蕾舞团
联防队	治安联合防卫队
血防办	血吸虫防治办公室
八办	八路军办事处
储汇局	储蓄汇兑局
农政部	农村政治部
内航局	内河航运局
养征所	养路费征收所
股价	股票价格
船位	船位置
汤杯	汤姆斯杯
民庭	民事法庭
呼盟	呼伦贝尔盟
中残	中国残疾人联合会
脱岗	脱离岗位
中港公司	中国港湾工程公司
临工委	临时工作委员会
科社部	科学社会部
打私办	打击走私活动办公室
厂纪	工厂纪律
概览	大概浏览
小巴	小型巴士
铁路法院	铁路运输法院
中汽总	中国汽车运输总公司
文博院	文物博物院
男高	男高音
下议员	下议院议员
农科户	农业科技户
物利公司	物资回收利用公司
亚太地区	亚洲和太平洋地区
北医	北京医学院
澳基咨会	澳门基本法咨询委员会
初教	初等教育
安委会	安全生产管理委员会
学委	学习委员
商储	商品储运
乡企	乡镇企业
指检	用手指检查
商况	商业情况
报章	报刊文章
无机化工	无机化学工业
承销	承运销售
被服	棉被和衣服
调节会	调节委员会
核试验	核武器试验
市话	市区电话
中医药局	中医药品管理局
体工	体育工作
修宪	修改宪法
宿管会	宿舍管理委员会
经研	经济研究
药浴	药液沐浴
航管所	航务管理所
空地导弹	空对地导弹
外研所	外国语言研究所
打防建	打击防范建设
社教司	社会科学教育司
田管	田间管理
旅展	旅游展览
航电	航空电磁法
续聘	继续聘用
胰石	胰腺结石
罚则	处罚原则
守疆	守卫边疆
税企	税务企业
水署	香港水务署
软交会	软件交易会
优才	优秀人才
教文	教育和文化
汽教	汽车教练
上飞	上海飞机制造厂
中企协会	香港中国企业协会
五四三	五讲四美三热爱
访客	来访的客人
经作所	经济作物研究所
东运会	东亚运动会
国安委	国家安全委员会
建外	建国门外
文宣队	文艺宣传队
考委会	考试委员会
协管员	协助管理员
科教所	科学教育研究所
橡塑厂	橡胶塑料厂
组工	组织工作
美劳	美术与劳作
修章	修改章程
刑释人员	刑满释放人员
发承包	签发承包合同
上航	上海航空公司
电视机	电视接收机
老协	老年人协会
摄记	摄影记者
泳技	游泳技术
机电公司	机电设备供应公司
类风关	类风温性关节炎
机械委	机械工业委员会
洛玻	洛阳玻璃股份有限公司
一拖	洛阳第一拖拉机厂
统招	统一招生
捷通社	捷克通讯社
重教	重视教育
农中	农业中学
国际联运	国际铁路货物联运
性病	性传播疾病
世青会	世界青年运动会
政企	行政和企业
西画	西洋画
轻铁	轻型轨道铁路
研析	研究分析
军训团	国民党庐山军事训练团
少足	少年足球
财相	财政相
食监	食品卫生监督检验
纳指	纳斯达克综合指数
老弱病残孕	老年人体弱者病人残疾人孕妇
道琼斯指数	道琼斯股票价格平均指数
群管	群众管理
工管会	工人管理委员会
制衡	控制平衡
公铁	公路铁路
简政放权	精简政府机构下放权限
国台办	国务院台湾事务办公室
交行	交通银行
联保	联合保险
抗宣队	抗日宣传队
治贪	惩治贪污
期权	期货合作选择权
诈财	诈骗钱财
青少体校	青少年体育运动学校
投产	投入生产
建材厂	建筑材料厂
亚组委	亚洲体育运动会组织委员会
影联	电影工作者联盟
行蓄	行洪蓄洪
华航	台湾中华航空公司
本利	本金和利息
路盗	拦路强盗
商战	商业战争
关余	关税余额
拒付	拒绝支付
慈联	慈善联合会
网膜	视网膜
公判	公开宣判
贸易法委员会	联合国国际贸易法委员会
中科大	中国科技大学
体测	体育项目测验
文教公司	文化教育用品公司
青创会	青年作家创作工作会议
评职	评定职称
工农副	工业农业和副业
健医发展咨委会	健康及医务发展咨询委员会
显绩	显著成绩
律署	香港律政署
劳保医疗	劳动保险医疗
联青委	澳门联谊总会青年委员会
违约	违反合同和契约
猜断	猜测判断
边检	边防检查
三十中	第三十中学
控污	控制污染
市宫	市工人文化宫
鳏寡	鳏夫寡妇
拘审	拘留审查
抗属	抗日军人家属
马列主义	马克思列宁主义
甲肝	甲型病毒性肝炎
国统	国民党统治
社政	社会政治
保教	保育教育
五十九中	第五十九中学
四机部	第四机械工业部
摘播	摘要播送
仓租	仓库租金
冷背	冷门背时
伤病残	受伤生病残疾
前总	前线总指挥部
校企	学校企业
游斗	游街批斗
政指	政治指导员
科图法	中国科学院图书分类法
中青社	中国青年出版社
青交	中国青年交响乐团
收证	收集证据
街总	街坊总会
南商	南洋商业银行
北图	北京图书馆
十五小	第十五小学
失政	失掉政权
银监	银行监理
科艺楼	科技艺术楼
艺大	艺术大学
承贷方	承担贷款方
科大	中国科学技术大学
阿联	阿拉伯联合共合国
中央社	中央通讯社股份有限公司
产运销	生产运输销售
蛋白酶	蛋白水解酶
水保	水土保持
房务部	客房服务部
超编	超过编制
西农大	西北农业大学
盲校	盲人学校
选育	选择和培育
节育	节制生育
生均	每个学生平均
地价	土地价格
暂押室	暂时看押室
联产计酬	联系产量计算报酬
外经委	对外经济委员会
区署	香港区域市政公署
红中社	红色中华通讯社
侦译	侦查破译
话研会	话剧研究会
批捕	批准逮捕
铁联	国际铁路联盟
经合	经济合作
风蚀	风力侵蚀
扩容	扩大容量
亚青杯	亚洲青年杯
六机部	第六机械工业部
轻汽	轻型汽车
行风	行业作风
抗改	抗拒改造
妇干班	妇女干部培训班
中化	中国化工进出口总公司
舍饲	圈舍饲养
训竞处	训练竞赛处
修院	修道院
民调会	民事调解委员会
三百	第三百货
八一厂	中国人民解放军八一电影制片厂
开发署	联合国开发计划署
北林大	北京林业大学
防核	防御核武器
安控	安全控制
信访	人民来信来访
统发	统一发布
预警	预先警告
尿检	尿样检查
宪制科	宪制事务科
政法宣教	政法宣传教育
工理文医艺	工科理科文科医科和艺术
军妓	随军妓女
批斗会	批判斗争大会
特诊	特殊诊疗
仔裤	牛仔裤
军邮	军队系统邮政
彩电	彩色电视
中募委	中国募捐委员会
展映	展览放映
艺创	艺术创作
艺检	艺术政策检讨小组
土管员	土地管理员
农工部	农村工作部
纺品	纺织品
孤老残幼	孤寡老人残疾人和幼童
科教文卫	科学教育文化卫生
时事社	时事通讯社
打黑扫恶	打击黑势力扫除恶势力
美央	美国中央银行
房管办	房产地产管理办公室
语言所	语言研究所
摩协	摩托车协会
九冬会	第九届冬季运动会
机管局	机场管理局
影星	电影明星
反贪科	反对贪污贿赂工作科
聘期	聘用期限
绿化委	绿化委员会
控办	控制社会购买力办公室
校工	学校工人
同济	同济大学
国足	中国足球队
一幼	第一幼儿园
复降	复方降压灵药片
哈工大	哈儿滨工大
农转工	农业剩余劳动力和转为工人
邮发	邮递发行
排险	排除危险
大批	大批判
话线	电话线
引销	引导销售
清欠	清理欠款
上轻院	上海轻工业设计院
超员	超过定员
随附	伴随依附
区局	香港区域市政局
运价	运输价格
21中	第21中学
派任	分派委任
企划部	企业规划部
汽技改	汽车技术改造
电总	电信总局
国家计委	国家计划委员会
检修	检查和修理
编审委员会	编制审定委员会
匪霸	土匪和恶霸
中委	中央委员
桥联	桥牌联合会
史训	历史教训
槛球	橄槛球
剑舞	剑器舞
参茸	人参鹿茸
文摘	文章摘要
内贸	对内贸易
供气	供应煤气
美国	美利坚合众国
体联	体育联合会
扫黄打非办	扫黄打非办公室
实态	实际状态
佛联会	香港佛教联合会
妇代会	妇女代表大会
139中	第139中学
摄协	摄影家协会
碟匣	磁碟匣
县府	县人民政府
中奥委	中国奥林匹克运动委员会
水阻	水流阻力
女团	女子团体
长训班	长期培训班
租星	租用国际卫星转发器
教卫工委	教育卫生工作委员会
控股	控制股份
铁三院	铁道部第三勘测设计院
天影厂	天津电影制片厂
青盐	青海省产食盐
农专	农业专科学校
乡企局	乡镇企业局
党委	中国共产党的委员会
汽贸	汽车贸易公司
公益	公共利益
荣退	荣誉退伍
干校	干部进修学校
矿管办	矿产资源管理办公室
卫检局	卫生检疫局
林牧农	林业牧业农业
云大	云南大学
票选	投票选举
轻校	轻工业学校
私企	私营企业
青干班	青年干部培训班
前委会	前敌委员会
机场	飞机场
生化所	生物化学研究所
瓶啤	瓶装啤酒
受访	接受访问
清房	清查住房
成府	成都政府
刑警局	刑事警察局
中队委	少先队中队委员会委员
刊校	刊授学校
美联社	美国联合通讯社
待岗	等待岗位
战况	作战情况
匈共	匈牙利共产党
省检	省检察院
增销	增加销售
智能所	智能研究所
运贸	运输贸易
查危小组	检查危险品小组
中国纺大	中国纺织大学
人权委	人权委员会
彩版	彩色版面
省总	省总工会
国际计生联	国际计划生育联合会
维港	维多利亚港
报捕	呈报批捕
标售	标价出售
早中晚	早晨中午晚上
参股	参加股份
莫大	莫斯科大学
上大	上海大学
公劳保	公共劳动保障
机助制图	计算机辅助制图
台剧	台湾戏剧
拥军	拥护人民军队
超值	物超价值
七棉	第七棉纺织
择恋	选择恋人
格城	格林纳达城市
外经外贸	对外经济对外贸易
拖配	拖拉机配件
石化安	石油化工安全
哈医大	哈尔滨医科大学
青交会	青岛商品交易会
商职校	商业职业学校
三教	第三教室
消指	消费物价指数
安保员	安全保卫人员
曲作家	词曲作家
工展会	工业展览会
汉印	汉代印章
苦研	刻苦钻研
开播	开始播放
餐营	餐车经营
餐旅	餐饮旅游
扩编	扩大编制
阅处	阅读处理
共治	共同治理
水煤	自来水和煤气
治则	治疗原则
中投公司	台湾省中央投资公司
商游	商业旅游业
机绣	机器刺绣
上体馆	上海体育馆
特钢	特种钢材
居委会	居民委员会
中信公司	中国国际信托投资公司
品管	品质管理
摩步师	摩托化步兵师
总编	总编辑
语工	语言文字工作
市选	市政委员会选举
核研所	核能研究所
台湾两岸	台湾海峡两岸
教工委	中共产党高教工作委员会
国标	国家标准
消总	消防总队
科技户	科技示范户
彩报	彩色报纸
任中审	任期中审查
菲侨	菲律宾籍侨民
乡直	乡直属
快邮	快递邮件
工农青妇	工会农会青年团和妇女联合会
农能办	农业能源办公室
流水线	流水生产线
绍鸭	绍兴麻鸭
产咨会	产业咨询委员会
老少边山	革命老区少数民族地区边境地区和山区
突审	突击审讯
浙警	浙江警察
沈空	沈阳军区空军部队
利改税	上缴利润改为上缴税金
存储	存款和储蓄
帮教	帮助和教育
税制	税收制度
进价	最高购进价
查究	检查追究
环咨会	环境污染问题咨询委员会
皮博会	皮革博览会
控区	控制区
质管	质量管理
中电	香港中华电力有限公司
家计会	香港家庭计划指导会
警匪	警察匪徒
裸镜	裸体镜头
茶科所	茶叶科学研究所
证监委	证监委员会
理事会	理事委员会
灌排	灌溉排放
矿冶	矿物冶炼
海校	海军学校
太阳电池	太阳能电池
捕判	逮捕查判
定编	确定人员编制
津人盟	津巴布韦非洲人民联盟
拆违	拆违章建筑
战工会	战时推行工作委员会
特需	特殊需要
制修厂	制造修理厂
平教运动	平民教育运动
农科	农业科学
从影	从事电影工作
水电大	水利电力大学
营收	营业收入
官校	军官学校
深证所	深圳证券所
林牧副渔	林业牧业副业渔业
农研会	农业经济研究会
国际滑联	国际滑冰联盟
现行	现行反革命
中概股	中国概念股
快递	特快专递
清污	清除污水
大龄	大年龄
汇制	汇兑制度
美新处	美国新闻处
商标权	商标专用权
国际网联	国际网球联合会
军统局	国民政府军事委员会调查统计局
外销	对外销售
上棉	上海棉纺织厂
港童基金	香港联合国儿童基金委员会
平米	平方米
针联	针灸学会联合会
农保办	农保办公室
贩私	贩卖走私物品
女工	女工人
话簿	电话簿
民主青联	中华全国民主青年联合会
亚泳联	亚洲游泳联合会
护工	护理工人
骨龄	骨骼的发育年龄
虔聆	虔诚聆听
港人	香港人
电建	电力建设
邮科院	邮电科学研究院
贸盈	贸易盈余
贪检科	反贪污检察科
荣校	荣誉军人学校
拳委	拳击委员会
片酬	拍电影电视片的酬金
体健	身体健康
刑侦科	刑事侦查科
品学	品行学业
锚地	锚泊地
朝医学	朝鲜族医学
美航	泛美航空公司
国联	国际联盟
强迁	强制迁移
中华文协会	中华文化协会
残部	残余部队
舞师	舞蹈教师
煤管局	煤炭管理局
电修	电机修理
农牧局	农业畜牧业局
路服	铁路制服
经援款	经济援助贷款
成果办	科学研究成果办公室
明细账	明细分类账簿
通胀率	通货膨胀率
爱盲	爱护盲胞
违章	违反规章
参游	参加旅游
武大	武汉大学
饭贴	饭钱补贴
山老边贫	山区老区边区贫困地区
抗暴	反抗暴力
自贸区	自由贸易区
自考办	高等教育自学考试办公室
促销扩产	促进销售扩大生产
打击办	打击经济领域严重犯罪活动办会室
行管部	行政管理部
副研	副研究员
水保林	水土保持防护林
技监	技术监督
后授	后方授助
医卫体委员会	医药卫生体育委员会
一建公司	第一建筑工程公司
优抚制度	优待抚恤革命军人及其家属的制度
征管科	征收管理科
家肥	农家肥料
预提	预备提拔
交建公司	交通建筑工程公司
路警	铁路警察
中国网协	中国网球协会
城管	城市管理
三十七中	第三十七中学
名权位	名誉权利地位
日均	每日平均
声镜	声学显微镜
航警局	台湾航空警察局
铁律	铁的规律
互贸区	互助贸易区
女台	女子跳台跳水
督办	督促办理
参典	参加典礼
退联	退休职工联合会
早教	早期教育
欧市	欧洲市场
医改办	医疗改革办公室
车程	行车路程
固体导弹	固体推进剂导弹
质标	质量标准
安影	安徽电影制片厂
足联	足球联合会
左翼剧联	中国左翼戏剧家联盟
招教	招聘教师
房建办	房屋修建办公室
群体司	群众体育司
从商	从事商业
列检所	列车检修所
石油化工	石油化学工业
药商	药品商
插青	插队知识青年
性征	性别特征
照护	照顾护理
考研	报考研究生
室乐团	室内乐团
高复班	高考复读班
节市	节日市场
自爆	自行爆炸
驻京办	驻京办事处
技侦	技术侦察
少儿委	少年儿童基金委员会
组干科	组织干部科
书刊	图书和期刊
研译	研究破译
入关	加入关贸总协定组织
音舞系	音乐舞蹈系
东盟	东南亚国家联盟
共商	共同商议
国际帆联	国际帆船联盟
郑交所	郑州交易所
职防	职业病防治
农救会	农民救国会
社党	社会民主党
工代大会	工人代表大会
天民党	天主教民主党
对外文委	对外文化联络委员会
党群	政党人民群众
空调机	空气调节机器
哲社	哲学社会科学
立法会	立法委员会
孤老	孤寡老人
特警班	特种警察人员训练班
昂亢	昂扬亢奋
金价	黄金价格
临参会	临时参议会
房展会	住房展览会
银联	银行职员联合会
景观图	景观地图
副高	副高级
专委	专门委员会
中华职教社	中华职业教育社
生救办	生产救灾办公室
纠风	纠正行业不正之风
中船总公司	中国船舶工业总公司
老记	老年记者
校运会	学校运动会
金融展	金融展览会
赛委会	竞赛委员会
防爆	防止爆炸
三防办	三防办公室
全救	全国各界救国联合会
馆藏	馆内藏品
2中	第22中学
中纺	中国纺织建设公司
岗培	岗位培训
附件	附属类小部件
拒批	拒绝批准
免检	免予检查
青辅会	台湾青年辅导委员会
招商	招引客商
军列	军人列车
井排	竖井排水
国际军体五项赛	国际军事体育五项锦标赛
对外经贸部	对外经济贸易部
专升本	专科毕业生升入本科
建安公司	建筑安装公司
财干院	财政干部学院
咸政	咸阳政府
青标手	青年标准化操作手
计陷	设计陷害
民革	中国国民党革命委员会
劳资	劳方和资方
试婴	试管婴儿
地标	地方统一标准
自协	自行车运动协会
文印	文件打印
广铁局	广州铁路局
农工贸旅	农业工业贸易旅游
寄研所	寄生虫病研究所
赤几	赤道几内亚
律管司	律师管理司
血龄	患血吸虫病病龄
首演	首场演出
三线办	三线办公室
组队	组成代表队
中农信	中国农业发展信托投资公司
司助	司法救助
杞忧	杞人之忧
邮展	邮票展览
工装	工艺装备
抗美援朝	抗击美国侵略援助朝鲜人民
伙补	伙食补贴
官小	官立小学
世青田径赛	世界青年田径锦标赛
残奥运	残疾人奥林匹克运动
军政民	军队政府人民
偏科	偏重某些学科
同盟社	日本同盟通信社
影业	电影业
统配物资	国家统一分配物资
广电报	广播电视报
劳务办	劳动力管理服务办公室
伴唱带	伴随歌唱的录像带
温病	温热病
创优	创新优质产品
特教班	特殊教育班
上外	上海外国语学院
卫浴	卫生浴室
评先创优	评选先进创优秀
营业税	营业所得税
吉大	吉林大学
合委会	合作委员会
书赛	书法比赛
抓俘	抓捕俘虏
抽红	抽取红利
青艺	中国青年艺术剧院
优种	优良品种
暑训班	暑期训练班
纳税人	纳税义务人
扩干会	扩大干部会议
农电站	农村电站
学童	上学的儿童
获颁	获得颁奖
鲁艺	鲁迅艺术文学院
扩灌	扩大灌溉面积
法援署	香港法律援助署
黄赌毒	黄色赌博毒品
国税所	国家税务所
批转	批示后转发
仪美	仪态美
婉拒	婉言拒绝
商检	商品检验
精油	香精油
女校	女子学校
判监	判处监禁
私倒	私人倒买倒卖
校委会	校务委员会
中国	中华人民共和国
女网赛	女子网球比赛
民促	民主促进会
函院	函授学院
宇航	宇宙航行
财年	财政年度
积层电池	积层式锌锰干电池
经审委	经济审查委员会
陆院	陆军学院
土军	土耳其军队
统检	统一检查
国际冰联	国际冰球联合会
南盟	南亚区域合作联盟
调控	调节和控制
食疗	饮食疗法
铁十七局	铁道部第十七工程局
航摄机	航空摄像机
握别	握手告别
昆腔	昆山腔
护肤	保护皮肤
企业工委	中国共产党企业工作委员会
汽运公司	汽车运输公司
联管办	联合管理办公室
边关	边境海关
全质办	全面质量管理办公室
赏樱	观赏樱花
特优	特别优惠
杜诗	杜甫的诗
殡改	殡葬改革
中建一局	中国建筑工程总公司第一工程局
体协	体育协会
药物所	药物研究所
西北师大	西北师范大学
教科文卫体	教育科学文化卫生体育
中国新闻学会	中国新闻学会联合会
体工队	体育工作队
肃贪	肃清贪污
抄抓	抄家和抓人
商联会	全国商业联合会
马传贫	马传染性贫血病
东语系	东方语言学系
经联社	经济联合社
台企	台湾企业
送评	送交评比
农技	农业技术
去今	去年今年
义工	义务工作者
商检局	商品检验局
前话	前进话剧团
欧足联	欧洲足球联合会
科工办	科技工业办公室
文教科技	文化教育科学技术
持平	保持平衡
查缉	追查缉捕
劳均	每个劳动力平均
新兵训	新兵训练
商台	商业电台
公投会	公民投票促进委员会
贩黄	贩卖黄色淫秽物品
热工	热能工程
森工	森林工业
国际客协	国际旅客联动协定
劳动管理	劳动行政管理
作训处	作战训练处
珍稀	珍贵和稀有
便民	方便人民群众
企业维简费	企业维持简单再生产费用
禁药	禁止用的药物
北汽摩	北京汽车摩托车联合制造公司
社教	社会教育
车损	汽车损坏
邮协	集邮协会
外文系	外国语言文学系
解放军体院	中国人民解放军体育学院
乡企办	乡镇企业办公室
维权委	维护权益委员会
干审	干部审查
中纺大	中国纺织大学
中治委	中央社会治安综合治理委员会
私交	私人间的交情
自查	自己检查
老年委	老年人委员会
电玩	电动玩具
制宪	制定宪法
青干	青年干部
超储	超过储藏期储存
平调	平级调动
维医	维吾尔族医学
美联储	美国联邦储备委员会
下权	下放权力
调解会	人民调解委员会
国际划联	国际划艇联合会
家庭承包制	家庭联产承包责任制
创议	创新建议
交投	交易投资
竞销	竞争销售
首图	首都图书馆
脱困	脱离困境
高校工委	高等学校工作委员会
公残	因公致残
捷运	快捷运输
军品	军用产品
亚足联	亚洲足球联合会
马恩著作	马克思和恩格斯的著作
攻削	进攻削球
浮动价格	幅度浮动价格
专运处	铁道部专列运输处
西滨	台湾西部滨海地区
二炮	中国人民解放军第二炮兵部队
特展	特别展览会
中储券	中央储备银行竞换券
捕治	逮捕惩治
扩校	扩大学校
公关	公共关系
国家民委	国家民族事务委员会
话机	电话机
支内	支援内地建设
缺工	缺乏工人
残童	残疾儿童
海空	海上和空中
陆航	陆军航空兵
中乐	中国音乐
群采	群众性采矿业
员生	教员和学生
金市	黄金市场
党政军	党组织政府部门军队
中出商会	香港中华出入口商会
世界工联	世界工会联合会
积委会	积极分子委员会
民矿	民办矿业
师院	师范学院
全国青联	中华全国青年联合会
报检	申报检验
报刊	报纸和刊物
中波海运公司	中国波兰海上运输公司
农科园	农业科技园
抽评	抽样评比
民盟	中国民主同盟
中小	中型小型
契税	契约税
教德	教师职业道德
射频	发射电波频率
救捞局	海难救助打捞局
评委	评选委员会委员
名校	知名学校
田径	田赛和径赛
三产	第三产业
煽惑	煽动蛊惑
人卫站	人民卫生站
信投公司	信托投资公司
航母	航空母舰
拒检	拒绝接受检查
税银	税务银行
税改办	税改办公室
土建	土木建筑
政审	政治审查
秋交会	秋季商品交易会
建协	建筑协会
环艺系	环境艺术系
外资委	外商投资工作委员会
人道立场	人道主义立场
奥体	奥林匹克体育
初一	初中一年级
长二丙	长征二号丙
编导演	编剧导演演员
俄航	俄罗斯航空公司
色温	颜色温度
马哲史	马克思主义哲学史
水电	水力发电
农话	农村电话
征稽所	征收稽查所
人民政协	中国人民政治协商会议
家服	家庭服务
退科联	退休离休科技工作者联合会
保单	保险单
联委会	联合委员会
统促会	中国和平统一促进会
人卫	人民卫生
陪侍	陪伴侍候
牛罐	牛肉罐头
抗宣	抗日宣传
森警	森林警察
项次	项目和次数
校注	校勘和注释
征纳	征收交纳
法队	法国队
拓边	开拓边疆
抗洪	抵抗洪水
提价	提高价格
自评	自己评价
水管会	水利管理委员会
特供	特殊供应
投建	投资建设
假期托	假期托管
皮肌	皮肤肌
中院	中级人民法院
联地	联合地产
整干	整顿干部作风
港片	香港影片
反导条约	限制反弹道导弹系统条约
副练	副练马师
国列	国际旅客列车
教图公司	中国教育图书进出口公司
亚太电信组织	亚洲和太平洋地区电信组织
上戏	上海戏剧学院
进窥	进犯窥探
二秘	二等秘书
北影	北京电影制片厂
亚洲棋联	亚洲象棋联合会
中图公司	中国图书发行公司
外军	外国军队
编委	编辑委员会委员
纯善	纯朴善良
煤化工	煤炭化工
市政局	市政工程管理局
揪斗	揪出来批判斗争
色斑	色素斑点
高新区	高新技术产业开发区
优幅	优惠幅度
家托	家庭托儿所
经货联盟	欧洲经济货币联盟
飞行力学	大气层飞行动力学
日航	日本航空公司
世基联	世界基督教联合会
市编委	市编辑委员会
平交	平面相交
城管局	城市管理局
税检	税收检查
中救	中国救亡剧团
女配	女配角
现代舞	现代派舞蹈
病退	因病退职
请调	申请调离
杭大	杭州大学
护绿	保护绿化
上证30	上海证券30
会董	总会董事
参访	参观访问
少边穷	少数民族边远贫穷
中工大	中南工业大学
涉台	涉及台湾
行管	行政管理
上录厂	上海录音器材厂
欧乒赛	欧洲乒乓球锦标赛
谐洽	和谐融洽
直选	分区直接选举
低下家庭	经济收入低生活贫困的下等家庭
促和促和	促进和平促进和解
天启	上天的启示
信博会	信息技术创新国际论坛暨博览会
群工	群众工作
中国少先队	中国少年先锋队
国基会	国际货币基金会
折让	折价让利
教管会	教育管理委员会
党政军民	党组织政府部门军队民众团体
联产	联系产量
比学赶超	比先进学先进赶先进超先进
民办	民间兴办
义消	义务消防队
蒋特	国民党蒋介石特务
护鸟	保护鸟类
日用品	日常生活用品
片库	影片仓库
美校	美术学校
落政	落实知识分子政策
空港	航空港
思研会	思想政治工作研究会
中远公司	中国远洋运输总公司
物检员	物价监督检查员
太药	太原医药
物贸	物资贸易
云贵川	云南贵州四川
衣裤	衣服裤子
防汛总部	防汛总指挥部
濒管办	濒危物种进出口管理办公室
牙石	牙周结石
医预班	医学预科班
矫治	矫正治疗
股值	股票价值
尤杯	尤伯杯
植保	植物保护
共管	共同管理
自考生	参加自学考试学生
联合国教科文组织	联合国教育科学及文化组织
储运	储存运输
外秘	外交秘书
视帝	电视剧皇帝
犯例	违犯法例
西语系	西方语言文学系
垒协	垒球协会
林科所	林业科学研究所
招录	招聘录用
船院	船舶学院
管养	管理和养护
经贸部	对外经济贸易部
彩扩	彩色照片扩印
科任	科考任务
唯物史观	唯物主义历史观
财经文教	财政经济文化教育
公卫	公共卫生
停牌	停止挂牌营业
外院	外国语学院
空战	空中作战
青委会	青年工作委员会
内存	内部存储器
优稿	优秀稿件
限速	限制速度
煤科院	煤炭科学院
面别	当面告别
软件所	软件研究所
棒运	棒球运动
租售价格	出租和出售价格
名片	著名影片
惩教署	惩罚教育署
高招办	高等学校统一招生办公室
名厨	著名厨师
二医大	上海第二医科大学
人普	人口普查
个税	个人所得税
政研	行政与科研
男模	男模特
初选	初步评选
坚拒	坚持拒绝
公投	公民投票
农田办	农田建设办公室
牡丹卡	牡丹信用卡
一建	第一建筑工程公司
严管	严格管理
航速	航行速度
自由区	工商业自由贸易区
经合组织	经济合作和发展组织
纺研院	纺织科学研究院
撤编	撤消编制
资讯	资源讯息
全国集邮联	中华全国集邮联合会
总后	中国人民解放军总后勤部
24中	第24中学
中油建	中国石油工程建筑公司
城防	城市防卫
合作所	合作制律师事务所
反属	反革命分子家属
东廊	香港东区走廊
地磁	地球磁性
医技	医疗技术
缩并	压缩合并
息率	利息率
华白豚	中华白海豚
中漆	中华制漆有限公司
电控	电气控制
军贸	军火贸易
邮市	邮票市场
粮药	粮食作物和药物作物
林研所	林业研究所
农林科学院	农业林业科学院
潜特	潜伏的特务
中央文委	中央人民政府文化教育委员会
验质	查验质量
职改	职称改革
院办	院长办公室
控释	控制释放
儿科所	儿童少年卫生科学研究所
棒协	棒球协会
舞协	舞蹈家协会
监销	监督销毁
粮经	粮食经济
文卫	文教卫生
自学考	高等教育自学考试
编创	编辑创作
艺盟	香港艺术家联盟
省编	全省统一编写
技防	技术预防
高校	高等院校
民安队	香港民众安全服务队
上音	上海音乐学院
亚冬会	亚洲冬季运动会
征接	征兵接兵
艺展	艺术展览
耗时	耗费时间
牺盟会	山西省牺牲救国同盟会
首钢	首都钢铁公司
减资	减少资本
减亏	减少亏损
国片	国产影视片
税利	税收和利润
排犹	排斥犹太人
户均	每户平均
宣教室	宣传教育室
外联部	对外联络部
打流	打击流氓犯罪
新高	新的高峰
中贸部	中央人民政府贸易部
墨通社	墨西哥通讯社
审概	审核概算
境管局	出人境管理局
编采播	编辑采访播音
扇超	扇形超声波
木函班	木刻函授班
耗能	消耗能量
侨团	华侨团体
代总长	代理总参谋长
医助	医生助理
曲论	词曲理论
彩扩机	彩色照片扩印机
警备	警务装备
农林水利	农业林业水利
冬奥运会	冬季奥林匹克运动会
三青团	三民主义青年团
拨改货	拨款改为货款
二五普法	第二个五年普及法律常识规划
十运会	第十届全国运动会
国补	国家补贴
新训办公室	新兵训练办公室
科教司	科学教育司
高能所	高能物理研究所
审荐	审查与推荐
南艺	南京艺术学院
统驭	统治驾驭
金杯公司	金杯通用汽车有限公司
一战	第一次世界大战
实测	实地测量
非洲经委会	非洲经济委员会
轮训	轮流培训
青旅	中国青年旅行社
国土局	国家土地管理局
两厨一厕	两间厨房一间厕所
社青	社会青年
艺研院	艺术研究院
经贸大学	对外经济贸易大学
住宅办	住宅办公室
高院	高级人民法院
自控所	自动控制研究所
内参	内部参考消息
全国文协	中华全国文学艺术工作者协会
禁赛	禁止参赛
税票	税收票证
文讲所	文学讲习所
军婚	军人婚姻
提职	提升职务级别
外专局	外国专家局
西南联大	国立西南联合大学
澳督府	澳门总督府
扩军	扩充军备
阜内	阜成门以内
政改	政治体制改革
妇协	香港妇女协会
专修班	专业进修班
台生	台湾学生
非统	非洲统一组织
粮改	粮食购销体制改革
交安会	维护道路交通安全委员会
济铁	济南铁路局
女监	女子监狱
惩署	香港惩教署
内宾	国内宾客
新股	新上市股票
超市	超级市场
审教	审判和教育
城隧	城市隧道
体彩	体育彩票
沙俄	沙皇俄国
国际赛联	国际赛艇联合会
团干	共青团干部
裂伤	撕裂伤
机织	机器纺织
质监员	质量监督员
食肆	食品摊肆
工纠	工人纠察
附随	依附伴随
管委	管理委员会
建科所	建筑科学研究所
涉老	涉及老年人
申装	申请安装
显外	显微外科
欧洲经委会	欧洲经济委员会
青妇	青年妇女
三电办	三电办公室
被装	棉被服装
陆航局	陆军航空兵局
督理	监督管理
农投	农业投资
三轮	三轮车
政工办	政治工作办公室
塑编	塑料编织
警消	警察与消防人员
黄淮海	黄河淮河及海河
西安体院	西安体育学院
科社	科学社会主义
上译厂	上海电影译制厂
招警	招考警察
职教组	职业教育组
证监处	香港证券事务监理处
报考	报名考试
咨委执委会	香港基本法咨询委员会执行委员会
文教卫生	文化教育卫生
航委会	航空委员会
电管所	电子管理所
国罗	国语罗马字
例验	例行检验
低噪	低噪声
打防	打击和防范
参众	参议众议
妊高症	妊娠高血压综合症
国图联	国际图书联合会
乒队	乒乓球队
音校	音乐学校
核查	核对检查
乔灌	乔木灌木
苦况	痛苦状况
编译	编写翻译
停捕	停止捕捞
绥署	绥靖公署
拉美社	拉丁美洲通讯社
计量局	标准计量局
春办	春节晚会办会室
筹拍	筹划拍摄
工商行	中国工商银行
粪管	粪便管理
苏菜	江苏菜系
纪工委	纪律工作委员会
韩商	韩国商人
国控	国家控制
花市	花卉市场
分委会	分委员会
讲习	讲授和研习
军委	中国共产党中央军事委员会
展销会	展览销售会
速滑	速度滑冰
上投公司	上海市投资信托公司
漫协	漫画救亡协会
和约	和平条约
蜂疗	用蜂毒治疗
抬价	抬高价格
九运会	第九届全国运动会
卫片	卫星照片
首信	首都信息技术有限公司
蒙汉	蒙古族和汉族
德甲	德国甲级足球联赛
活检	活体组织检查
企银	企业银行
盟体	联盟体
商贷	商业贷款
中共中央	中国共产党中央委员会
炮院	炮兵学院
整训	整编训练
抗大	中国人民抗日军事政治大学
库券	国库券
修护	修理维护
跌势	下跌趋势
初评	初次评选
待委	等待委任
包研会	包公研究会
医委会	医学委员会
经互会	经济互助委员会
东航	东方航空公司
一战后	第一次世界大战后
拳联	拳击运动联合会
高新	高新技术
驾机	驾驶飞机
面瘫	面部肌肉瘫痪
地产	土地资产
妇婴	妇女和婴儿
国家禁毒委	国家禁毒委员会
双人跳	双人跳水
应化	应用化学
柠茶	柠檬茶
追价	追高价格
文理工	文科理科工科
规土局	规划土地局
线报	线民报告
交运局	交通运输管理局
男服	男子服装
怒讨	愤怒声讨
法援	法律援助
爱卫办	爱国卫生运动委员会办公室
海榴	海石榴
参会	参加会议
关贸	关税及贸易
西海固	宁夏西吉海原固原
共青	中国共产主义青年团
指婚	指定婚姻
产联	产业工作联合会
血防	血吸虫病防治
解痉	解除痉挛
资信	投资信贷
安检机	安全检查机器
美商	美国商人
二炼钢	第二炼钢厂
美专	美术专科学校
新协	新闻工作者协会
劳培	劳务培训
家纺	家庭纺织
共育	共同教育
青影	青年电影制片厂
扶康会	扶助伤残人康复会
胎心	胎儿心率
市队	市代表队
禁核	禁止核武器扩散
焚坑	焚书坑儒
彩管	彩色管
追星站	追踪卫星站
外籍	外国国籍
督导	监督指导
平战	平时战时
火器伤	发火武器损伤
危鉴办	危房鉴定办公室
销文	销毁文件
农合工	农民合同制工人
工科贸	工业科技和贸易
体改委	经济体制改革委员会
科干局	科技干部局
中央音院	中央音乐学院
财税	财政与税收
艺专	艺术专科学校
排华	排斥华人
量化处	计量化验处
制程	制造过程
校团委	学校共青团委员会
领馆	领事馆
客列检	旅客列车检修所
海航	中国人民解放军海军航空兵
贸委会	贸易委员会
总工	总工程师
法国	法兰西共和国
劳团	香港劳工团体
摩步旅	摩托化步兵旅
新疆兵团	中国人民解放军新疆生产建设兵团
联管会	联合管理委员会
合练	联合排练
汇商	外汇商人
评模	评选模范
侨资	侨胞投入的资本
航路	航行路线
化工大	化学工业大学
地直	地区直属机关
洛轴	洛阳轴承集团有限公司
局地	局部地区
华裔	华人后裔
野政	野战军政治部
监管会	监督管理委员会
户粮关系	户口及粮油供应关系
中央青委	中央青年工作委员会
港星	香港影视歌星
一冶	第一冶炼厂
二轻	第二轻工业
残运会	残疾人运动会
治整	治理和整顿
罪因	犯罪原因
电贺	发电报祝贺
运势	命运形势
内报	内部报纸
企业办	企业办公室
村委	村民委员会
文教部	文化教育部
财保	财政保险
上广	上海人民广播电台
学运	学生运动
待业	等待就业
物价局	物价管理局
特服台	特殊服务台
影帝	电影皇帝
深证Ａ股	深圳证券Ａ股
农轻纺	农业轻工业和纺织业
酌处	酌情处理
存保制	香港存款保障制度
红大	中国人民抗日红军大学
倒币	倒卖货币
陶研	陶行知研究
一医	第一医学院
博交会	科技成果企业产品博览交易会
海科	海洋科学
港府	香港政府
韩航	大韩民国航空公司
本钢	本溪钢铁公司
机施公司	机械施工公司
超限	超过限度
退养	退休和养老
春麦	春播小麦
国优	国家级优质产品
科委	科学技术委员会
劳卫所	劳动卫生研究所
信贷社	信用贷款合作社
中华社大	中华社会大学
广教中心	广播教育中心
空管局	空中交通管理局
联名	联合署名
市商委	市商业委员会
复旦	复旦大学
人医	人民医院
赔付	为赔偿而支付
农教	农村教育
安监室	安全监察室
科影	科影厂
建陶	建筑陶瓷
影后	电影皇后
运管	运输管理
音雷	音感鱼雷
音协	音乐家协会
扶助会	扶助协会
评介	评论和介绍
文改会	中国文字改革委员会
电大	广播电视大学
上铁	上海铁路局
男羽队	男子羽毛球队
农资办	农业生产资料办公室
困斗	困兽犹斗
内战	国内战争
地科院	地质科学研究院
西隧	香港西区海底隧道
教培部	教育培训部
一小	第一小学
首航	首次航行
反标	反动标语
省运会	省级运动会
航管站	航务管理站
审稿	审阅稿件
房协	房屋协会
轮运	轮船运输
城改办	城市改造办公室
加航	加拿大航空公司
和大	保卫世界和平大会
理疗	物理疗法
统算	统一核算
计生所	计划生育研究所
澳航	澳大利亚航空公司
泳协	游泳协会
党工	党务工作
职教管委会	职业教育管理委员会
机关委	机关管理委员会
房贷部	房屋贷款部
短线团	短途路线旅游团
5中	第55中学
特犯	特殊犯人
残协	残疾人体育协会
收放机	收音放音机
园林办	园林办公室
查禁	检查禁止
旱改水	旱地改为水田
教科文卫	教育科学文化卫生
转机	转搭飞机
西工大	西北工业大学
旱作	旱地作物
万国邮联	万国邮政联盟
军运	军用品运输
文明委	精神文明建设活动委员会
创编演	创作编排演出
禁产	禁止生产
民爆器材	民用爆破器材
中国科大	中国科技大学
刑警	刑事警察
商旅	商业旅游服务业
燕大	燕京大学
欧华联会	欧洲华侨华人社团联合会
航贴	出海航行补贴
参选	参加选举
游干班	游击干部训练班
岸炮	海岸炮
思政	思想政治
农经委	农业经济委员会
藏师班	西藏师范班
敌产	敌人的财产
政务	行政事务
共大	江西共产主义劳动大学
恳商	恳切商谈
修甲	修理指甲
妇青委	全国妇联青年委员会
港监站	港务监督站
施检	施行检查
中信局	国民党中央信托局
房改办	城镇房屋制度改革办公室
班委会	班级委员会
休干	离休退休干部
音统处	香港音乐事务统筹处
教办	教育办公室
文史哲经	文学史学哲学经济学
安医大	安徽医科大学
地表	地球表面
军体院	中国人民解放军体育学院
独营	独资经营
合办	联合举办
全国考委	全国考试委员会
师大	师范大学
日银	日本银行
受托	接受委托
发育生物所	发育生物学研究所
预后	预测后果
浙昆	浙江昆剧团
蒙师	启蒙老师
夜航	夜间航行
密报	秘密报告
亚太经	亚洲太平洋经济
楼按	楼宇按揭
竞标	竞争投标
医护人员	医疗护理人员
男排	男子排球
淮委	治淮委员会
股指	股价指数
特检室	特别检查室
建行	中国人民建设银行
文印社	文件打印社
期市	期货市场
药具	医药器具
职数	职位数量
体专	体育专科学校
陕甘	陕西甘肃
混双	男女混合双打
商训	商业知识培训
台肥	台湾肥料公司
劳服科	劳动服务科
医研所	医学科学研究所
医署	香港医院事务署
均数	平均数量
外运公司	对外贸易运输公司
收审	收容审查
萧湘厂	萧湘电影制片厂
铁十六局	铁道部第十六工程局
维和行动	联合国维持和平行动
利税	利润和税金
自筹	自行筹集
机织厂	机器纺织厂
影赛	摄影比赛
整纪	整顿纪律
毒贩	毒品贩子
陈谢	陈瘐谢富治
检方	检察院方面
危改	危旧房屋改造
考录	经考试录取
邓选	邓小平文选
展研会	展览研究讨论会
1中	第11中学
外空	外层空间
水铁联运	水路和铁路联合运输
宣教处	宣传教育处
临全大会	国民党临时全体代表大会
落办	落实政策办公室
城雕	城市雕塑
粮棉	粮食和棉花
贸工部	贸易工业部
中国乒协	中国乒乓球协会
企协	企业家协会
婚书	结婚登记书
中演	中国对外演出公司
评审委	评审委员会
文研所	文学研究所
民航局	中国民用航空管理局
空冷设备	空气冷却设备
职评	职称评定
社群	社会群体
晚少优	晚婚晚育少生优生
皮试	皮下注射试验
短导	短程核导弹
信访局	人民来信来访局
档级	档次和级别
专武干部	专职武装干部
包产	承包产量
质协	质量管理协会
血防所	血吸虫病防治所
阿盟	阿拉伯国家联盟
个协	个体协会
禁登	禁止刊登
脱星	脱衣舞星
墨市	墨西哥市
中国文联	中国文学艺术界联合会
红属	红军家属
科艺宫	科技艺术宫
传布	传播散布
中语会	中学语文教学研究会
简评	简要评论
军转干	军队转业干部
现况	现实情况
中综委	中央社会治安综合治理委员会
关境	关口边境
体委	国家体育运动委员会
特警	特种警察
台糖	台湾糖业公司
减产	减少产量
影视录	电影电视录像
科教企	科学教育企业
议购	议价收购
证交所	证券交易所
卫协	卫生工作者协会
妇女会	妇女协会
国际摩联	国际摩托车运动联合会
文康	文娱康乐
影剧	电影和戏剧
台市	台湾股市
移民办	移民办公室
临管	临时管理
水运	水路运输
亚俱杯	亚洲俱乐部杯
地下核试	地下核武器试验
贵冶	贵州冶金
卫勤	卫生和后勤
党支	党支部
山胞	台湾山地同胞
虫草	冬虫夏草
农代会	农民代表大会
股评	股市评论
对外文联	对外文化联络委员会
主佣	主人和佣人
艺文	艺术文化
袭警	袭击警察
市百一店	市百货公司一店
皮簧	西皮和二簧
劳务所	劳动力管理服务所
业师	受业导师
欧安会	欧洲安全与合作会议
库存	仓库储存
港姐	香港小姐
普理	普通理科
行止	行为举止
影像	电影和录像
劳卫	劳动卫生
十五中	第十五中学
评委会	评选委员会
销势	销售形势
公出	因公外出
犯属	犯人家属
老弱孤寡	年老体弱孤儿和寡女
航商	航海运输商
书画展	书法绘画作品展览
军事医科院	军事医学科学院
美参院	美国参议院
坑道	坑道工事
总动委	总动员委员会
清档	清理档案
育乐	体育娱乐
车速	行车速度
产学	生产和教学
丝路	丝绸之路
铁二院	铁道部第二勘测设计院
解聘	解除职务不再聘用
电院	电子工程学院
公铁立交桥	公路铁路立体交叉桥
船研所	船舶运输研究所
农发基金会	国际农业发展基金会
春贷	春耕贷款
友联	友好联合会
助审员	助理审判员
美越	美国越南
朝族	朝鲜族
民力	民众力量
抗联	东北抗日联军
上远公司	上海远洋运输公司
荣复	荣誉复员
中文系	中国语言文学系
欧币体	欧洲货币体系
反美	反对美帝国主义
普外	普通外科
交咨会	交通咨询委员会
影制	电影发行体制
告申	告诉申诉
教干	教学管理干部
商服	商业服务业
亚音节	亚洲音乐节
企办	企业办公室
禁飞	禁止飞行
检视	检查与审视
10中	第10中学
劳委会	台湾劳工事务委员会
脱盲	摆脱文盲
政银企	政府银行企业
农函	农业函授
兰大	兰洲大学
经建	经济建设
午休	午间休息
农专班	农业专科班
水土站	水土保持工作站
农协会	农民协会
少体校	少年业余体育学校
结脑	结核性脑膜炎
尊老	尊重老人
通航	中国通用航空公司
直客	直通旅客列车
航院	航空学院
钢混结构	钢筋混凝土结构
受赠	接受馈赠
垒联	垒球联合会
西安厂	西安电影制片厂
恶攻	恶毒攻击
安置办	退伍军人安置办公室
非公经济	非公有经济
房屋仲裁委	房屋纠纷仲裁委员会
全国影协	中华全国电影工作者协会
电刮刀	电动刮须刀
矿治	矿物治炼
内贸部	国内贸易部
地埋	地下埋藏
帝大	日本东京帝国大学
地工	地下工作
特委	特别委员会
荧光造影	眼底荧光素血管造影
劳技	劳动和技术
国际泳联	国际业余游泳联合会
生物所	生物研究所
发照	发给执照
在培	在职培训
南大	南京大学
泌乳	分泌乳汁
解严	解除戒严状态
协勤警	协助勤务警察
一机局	第一机械工业局
家财险	家庭财产保险
煤化所	煤炭化学研究所
油建	油田建设
警保处	警察保安处
轻专	轻工业专科学校
世贸组织	世界贸易组织
警署	警察署
生管委	生活管理委员会
乒羽	乒乓球羽毛球
尼大	尼赫鲁大学
空勤家属	空中和地勤人员家属
商住房	商业住房
引智办	引进国外智力领导小组办公室
油雕院	油画雕塑院
标煤	标准煤
水管部门	水利管理部门
县府办	县人民政府办公室
省港澳	广东省香港地区澳门地区
开埠	开辟城埠
国企转制	国有企业转制
陆大	陆军大学
体脑倒挂	体力劳动与脑力劳支收入倒挂
冬修	冬季兴修水利
农林	农业和林业
民主妇联	中国全国民主妇女联合会
工兵农	工人士兵农民
初职班	初级职业班
市交委	市交通委员会
华野	中国人民解放军华东野战军
幼保	幼童保险
流腮	流行性腮腺炎
技校	技工学校
少青中老	少年青年中年老年
中戏	中央戏剧学院
研展会	研究成果展览会
省医	省立医院
中央财院	中央财政金融学院
撤诉	撤回诉讼
出租	出租汽车
国地税	国家地方税收
电教办	电化教育办公室
原子能所	原子能研究所
一机厂	第一机械厂
炮团	炮兵团
生产办	生产办公室
指诊	用手指诊断
石油部	石油工业部
会展中心	会议展览中心
亚姐	亚洲小姐
超标	超过标准
社科艺教司	社会科学研究与艺术教育司
亚洲手联	亚洲手球联合会
前敌总指挥部	前线对敌总指挥部
国统区	国民党统治区
月入	每月收入
单宿	单身宿舍
定补金	定期补助金
学协	学生界救亡协会
农建总公司	农村建设总公司
煤销站	煤炭销售站
能源办	能源办公室
爱卫会	爱国卫生运动委员会
牌委会	牌照委员会
大篮联	大学生篮球联合会
演词	演说词
春供	春季供应
公用局	公用事业局
全漫协	全国漫画家协会
助养	帮助扶养
步道	步行道路
将校	将官和校官
战史	作战史
协调委	协调委员会
大体协	大学生体育协会
采样	采集样品
起搏器	人工心脏起搏器
折卖	折价出卖
通膨率	通货膨胀率
业权	物业所有权
职工盟	香港职工会联盟
批销	批购零销
联集	联合集团
侨知联谊会	侨界知识分子联谊会
单耗	单位产品物资实际消耗量
组办	组织承办
几佛党	几内亚佛得角非洲独立党
国际摔联	国际业余摔跤联合会
北爱党	北爱统一党
体工站	体育工作站
美工	美术工作
降耗	降低消耗
教统会	香港教育统筹委员会
技交所	技术交易所
郑铁局	郑州铁路局
调温	调节温度
法制委	法制委员会
房修队	房屋修建队
夜大	夜大学
邀聘	邀请聘请
优用	优先使用
农广	农业广播
苏联	苏维埃社会主义共和国联盟
古史	古代历史
耻离症	耻骨联合分离症
厂校	工厂和学校
擂赛	擂台赛
工赈	以工代赈
儿保	儿童卫生保健
高教自考委	高等教育自学考试委员会
军运处	军用品运输处
党章	党的章程
调演	调集会演
外资	外国资本
上艺	上海艺术剧场
市售	市场销售
清拆	清理和拆除
拳赛	拳击比赛
转制办	转制办公室
劳服公司	劳动服务公司
高交会	中国国际高新技术成果交易会
主研人	主要研究人
上药厂	上海制药厂
棉农	种棉花的农民
针麻	针刺麻醉
演星	演员明星
禁映	禁止放映
旱原区	干旱和高原地区
运销	运输和销署
车贴	乘车补贴费
财经委	财政经济委员会
长债	长期国库债券
基建	基本建设
指委会	指导委员会
真红	真性红细胞增多症
波匈事件	波兰匈牙利事件
宗教局	宗教事务管理局
公决	公众表决
鱼统处	香港鱼类统营处
刑释	刑满释放
汉译	汉语翻译
办文	办理文件
执法办	执法办公室
海货	上海货
院务部	学院事务部
减负	减轻学生过重课业负担
文娱	文化娱乐
菲央行	菲律宾中央银行
私纺	私营纺织品
侦处	侦查处理
单产	单位面积产量
农委	农业工作委员会
科技委	科学技术委员会
乘警	乘务警察
恶黑	恶性黑色素瘤
增速	增长速度
机油	机械油
年资	年龄资历
广西厂	广西电影制片厂
工农贸	工业农业和贸易
世博会	世界博览会
策励	鞭策鼓励
贸展局	香港贸易发展局
平摊	平均分摊
延安鲁艺	延安鲁迅艺术学院
全国文联	中华全国文学艺术界联合会
商贸委	商业贸易委员会
产供销贸	生产供应销售贸易
梅程荀尚	梅兰芳程砚秋荀慧生和尚小云
临时托	临时托管
商管	商业管理
直升	直接升学
增盈	增加盈利
联贷	联合贷款
简办	简单办理
午宴	中午举行的宴会
打拐	打击拐骗买卖妇女儿童
关检	海关检查
负累	负担累赘
农经所	农业经济研究所
农发基金	农村发展基金
舞训班	舞蹈训练班
行装	行李装运
全非工联	全非洲工会联合会
晨褥	早晨褥告
解总	解放区救济总会
珠航	珠江航运公司
北师院	北京师范学院
澳元	澳大利亚元
泰旅局	泰国旅游局
植保所	植物保护研究所
县人委	县人大委员会
五交化	五金交电化工
科普	科学普及
工交城建	工业交通业和城市建设
违控	违反对社会集团购买的控制
民宗委	民族宗教委员会
中质协	中国质量协会
经计委	经济计划委员会
山工大	山东工业大学
台轮	台湾轮船
省地	省级地区级
老促会妇委会	中国老区建设促进会妇女委员会
邮检所	邮电检查所
林工商	林业工业和商业
长宽	长度宽度
干教	干部教育
科管	科学管理
北财	北京财政金融学院
会展区	会议展览区
联检	联合检查
肉联厂	肉类联合加工厂
脑体	脑力劳动和体力劳动
编著	编慕与著述
农灌水	农业灌溉用水
外烟	外国香烟
代销	代理与销售
冶机技术所	冶矿机械技术研究所
开业	开张营业
教职工	教师职员和工人
调价	调整价格
人武部人武部	人民武装部人民武装工作部
物总	物资总公司
侦破	侦查破案
经侦处	经济侦察处
川航	四川航空公司
南极办	南极考察委员会办公室
船管科	船只管理科
阿美石油公司	阿拉伯美国石油公司
建管	建筑管理
消委	消费者委员会
捕殖	捕捞养殖
中燃	中国船舶燃料供应总公司
基材	基本材料
清仓	清查仓库
财贸委	财政贸易委员会
丁型肝炎	丁型病毒性肝炎
校改	校对和改正
声光视效	声音灯光视觉效果
微电机	微型特种电机
反导	限制反导弹导弹系统
水管费	水利管理费
企检	企业和检察部门
商经	商业经济
基建办	基本建设办公室
外管局	外事管理局
国家商检局	国家进出口商品检验局
证管办	证券管理办公室
轮渡	轮船摆渡
呼市	呼和浩特市
要电	重要电报
授勋	授予勋章
航展	航空展览
文检	文字笔迹检验
徽商	徽州府籍商人
潜质	潜力素质
抓扒	抓扒手
俄商	俄罗斯商人
分配办	分配办公室
台统盟	台湾中国统一联盟
艺教委	艺术教育委员会
长休	长期休息
行颁	行业颁布
支农	支援农业
综防技术	综合防治技术
黄灌区	黄河灌溉区域
兵运线	兵站运输线
重汽集团	中国重型汽车集团
彩影	彩色摄影
打防控	打击防范控制
姿彩	姿态色彩
古研所	古迹研究所
厦府	厦门政府
港监局	港务监督局
中央文革	中央文化革命领导小组
有研	有色金属研究所
整军	整顿军队
内阅室	内部刊物阅览室
临建	临时建筑
批价	批发价格
赛程	比赛日程
文改	文字改革
助编	助理编辑
免职	免去职务
研练	钻研练习
汇演	汇报演出
专责	专门负责
个体户	个体工商户
法航	法国航空公司
片警	分片管辖户籍的警察
技导	技术指导
饮服	饮食服务
富政	富裕政策
劳改	劳动改造
干休	干部休养
超屏	超大屏幕
节煤	节约用煤
暂编师	暂时编制师
制售	制造和销售
延烧	蔓延燃烧
亚帆赛	亚洲运动会帆船帆板竞赛
中侨委	中央人民政府华侨事务委员会
广获	广泛获得
捐赠	捐献赠送
募委办	募捐委员会办公室
文办	文化办公室
电教	电化教学
国际马联	国际马术联合会
安保	安全保卫
联合国粮农组织	联合国粮食和农业组织
禁核试	禁止核武器试验
社联	社会科学界联合会
陕公	陕北公学
日化	日用化学工业
中农网	中国农业网
国际路协	国际道路会议常设协会
工伤会	香港工业作业伤亡权益会
特情	特别情报
步炮	步兵和炮兵
触令	触犯法令
调处	调解和处理
亚星	亚洲通讯卫星
外贸部	对外贸易部
酒钢	酒泉钢铁公司
煤电油运	煤炭工业电力工业石油工业运输业
国际游联	国际业余游泳联合会
参训	参加训练
矿院	矿冶学院
招考办	招考办公室
过境税	过境关税
镇保	小城镇社会保障制度
柔杆	柔性钻杆
统分	统一分配
瓦检员	瓦斯检测员
征兵办	征兵办公室
科影厂	科学教育电影制片厂
学工部	学生工作部
武联	武术联合会
按资分配	按资金或资本大小进行利益分配
高参	高级参谋
碍航	妨碍航行
春训办	春季训练办公室
土发	香港土地发展公司
老遂	香港大老山遂道
宣发处	宣传发行处
工运会	工作运动会
优遇	优惠待遇
世妇联	世界妇女联合会
高护	高级护士
外贸	对外贸易
日贷	日本贷款
观展	参观展览
军基	军事基地
家电	家用电器
乡代会	台湾乡民代表大会
时空观	时间和空间观念
经审	经济审查
中总	香港中华总商会
特检	特别检查
足总杯	英格兰足球总会杯
溶贫	溶血性贫血
国家计生委	国家计划生育委员会
欧工联	欧洲工会联合会
特教委员会	特殊教育委员会
亚远经委会	亚洲及远东经济委员会
长服	长期服用
亚青	亚洲青年
青运公司	青岛远洋运输公司
补差	补足收入的差额
师直	师直属机关
佳市	佳木斯市
举发	检举揭发
管护	管理和保护
中技公司	中国技术进口总公司
世卫组织	世界卫生组织
经二庭	经济审判第二庭
环保日	环境保护日
节本降耗	节约成本降低能耗
代耕	代为耕种
艺代会	艺术家代表会
病休	因病休息养
科工农贸	科技工业农业和贸易
内盗	内部偷盗
外供站	外汇物资供应站
南童	南童梓门
省图	省图书馆
综采	综合机械化采煤
高工	高级工程师
玻纤	玻璃纤维
边贸委	边境贸易委员会
主控台	主要控制台
澳抗	澳大利亚抗原
中演公司	中国对外演出公司
保共	保加利亚共产党
完封	完全封锁
扩红	扩大红军
平叛	平息叛乱
农牧渔	农业牧业渔业
中试部	中心试验部
少先队员	中国少年先锋队队员
航专	航海专科学校
调赛	调集竞赛
美编	美术编辑
贷放	贷款放款
果研所	水果研究所
军博	中国人民革命军事博物馆
家纠	家庭纠纷
微波通信	微波中继通信
教统科	教育及人力统筹科
直机关	直属机关
和运	和平运动
小企	小企业
车管科	车辆管理科
欧航局	欧洲航天局
化防	化学防治
刑拘	刑事拘留
男网	男子网球
柯族	柯尔克孜族
搜证	搜集证据
文印室	文件打印室
主裁	主裁判
招生办	招生办公室
兑汇	兑换外汇
关停并转	关团停产合并或转产
中水	中国水力电力对外公司
计控处	计量控制处
检获	检查缴获
住读	住校读书
台工委	台湾工作委员会
医协	医学协会
支现	支取现金
收支	收入和支出
反骄破满	反对骄傲破除自满
模具所	模具技术研究所
欧美	欧洲和美洲
普查	普遍检查
联储局	联邦储备局
起草委	起草委员会
量体	测量身体
航运局	航道运输管理局
北博会	北京博览会
家计所	家庭计划研究所
黄委会	黄河水利委员会
纤检	纤维检测
人教	人事教育
车况	车辆状况
心搏	心脏搏动
控亏	控制亏损
干管处	干部管理处
农经站	农业经济站
学院临管	学院临时管理委员会
农水处	农田水利处
实效	实际效果
伙管会	伙食管理委员会
解困	解决居民住房困难
市管	市级管制
公边	公安边防
一国两府	一个国家两个政府
中广联	中国广告联合总公司
主创	主要创作
日参众	日本参议院众议院
违泊	违例泊车
清运	清理与运输
世界科协	世界科学工作者协会
儿影厂	儿童电影制片厂
国际隧协	国际隧道协会
大众传媒	大众传播媒介
稽查办	稽查办公室
赛题	竞赛题目
妇代	妇女代表
侨胞	侨居国外的同胞
缩编	压缩编制
师德	教师道德
会所	聚会场所
交市	交易市场
参赛	参加比赛
孙大	孙逸仙大学
信资	信托投资
特批	特别批准
地防所	地方病防治所
徐派	越剧徐玉兰派
老少边贫	革命老区少数民族地区边境地区贫困地区
金银铜	金牌银牌和铜牌
政协会	政治协商会议
丹皮	牡丹根皮
旅专	旅游专科学校
中影公司	中国电影发行放映公司
限产压锭	限量生产压缩棉锭
社情	社会情况
招工	招收工人
速生	快速生成
社会购买力	社会商品购买力
律协	律师协会
一国两制	一个国家两种社会制度
工艺美校	工艺美术学校
和委会	和平委员会
参展团	参加展览代表团
商道	经商之道
计生联	计划生育联合会
林机厂	林业机械厂
上影	上海电影制片厂
青基金	青少年发展基金会
从教	从事教育工作
经院	经济学院
工疗	工人疗养院
维生	维持生活
游途	旅游路途
班队	班级和团队
行员	银行职员
年检	年度检审
全麻	全身麻醉
导淮会	疏导淮河工作委员会
收教	收容教育
中国工行	中国工商银行
动检站	动物检疫站
探班	探望上班者
责权利	责任权利利益
民初	民国初年
政宣科	思想政治宣传科
后市	后期市场
存保公司	存款保障公司
国大	国民代表大会
综艺	综合艺术
影技	摄影技术
集体工	集体所有制工人
联招	联合招生
教科所	教育科学研究所
作训	作战训练
访查	访问调查
牙防所	牙病防治所
财经	财政和经济
甄训	甄试与训练
社大	中华社会大学
运钞	运输钞票
学联	学生联合会
资源委	资源委员会
唱协	香港国际唱片业协会
切宫	切除子宫
短训班	短期培训班
冰盖	大陆冰面覆盖
婚恋	结婚恋爱
沃尔夫社	沃尔夫通讯社
精研	精心研究
宽忍	宽大容忍
名票	著名票友
中监委	中央人民政府政务院人民监察委员会
债信	债务信用
考点	考试场点
一中一台	一个中国和一个台湾
中教科	中等教育科
体博会	体育博览会
乒后	乒乓球运动皇后
转退军人	转业退伍军人
花博会	花卉博览会
文宣部	文化宣传部
旅美华侨	旅居美国的华侨
纺工	纺织工业
军报	解放军报
信贷	信用贷款
收储	吸收储蓄
殡葬	出殡和埋葬
税基	课税基础
联调组	联合调处民间纠纷小组
下探	向下探底
研议	研究商议
书研社	书法艺术研究社
澳督	澳门回归前葡萄牙政府委派的总督
物委	物资委员会
限行	限制行驶
新影厂	中央新闻纪录电影制片厂
办证	办理公证事务
澳属	澳门同胞的亲属
篮总	香港篮球总会
粮仓	粮食仓库
职教社	中华职业教育社
节能办	节约能源办公室
奥协	奥林匹克运动委员会协会
组设	组织设立
业委会	业主委员会
鞭花	鞭炮礼花
化轻公司	化学轻工业公司
津百	天津百货
亚唱	香港亚洲唱片公司
中经网	中国经济网
政治协商	中国人民政治协商会议
免责	豁免责任
反扒	反对扒手
委办	委员会办公室
保勤	保证出勤
西影	西安电影制片厂
蒙族	蒙古族
改制	改革机制
盟军	同盟国军
上美影	上海美术电影制片厂
弃婴	被遗弃的婴儿
胎甲球	胎儿甲/Mg 种球蛋白
电仪局	电子仪表工业局
海俱	海员俱乐部
主委会	主选委员会
政训	政治训练
人美	人民美术出版社
近交	近亲交配
联航	联合航空公司
减灾委	减轻灾害委员会
人保组	人事保卫领导小组
男监	男犯监狱
友协	友好协会
武邮院	武汉邮电学院
工盟	联合工会联盟
要项	重要项目
工商联	中华全国工商业联合会
停薪留职	停发薪水和保留公职
公评	公共房屋政策评议会
粮油集贸	粮食食油集中贸易
俄文系	俄罗斯语言文学系
特疗室	特殊治疗室
留置	滞留安置
内改	内部管理体制改革
宣教司	宣传教育司
街办	街道办事处
政训队	政治训导队
二简	第二次汉字简化方案草案
超支	超额支出
武星	武打明星
群像	群体形像
营销	经营销售
站修组	车站修理组
投购	投资投标购买
回瞻	回顾与瞻望
船舶证书	船舶检验证书
彩超	彩色B超
工交能	工业交通和能源
成校	成人教育学校
工属	职工家属
农科教	农业科学教育
劳平	每个劳动力平均
全代会	全国代表大会
中冶	中国冶金建设公司
共同体	欧洲经济共同体
计销	计划销售
成中	成人中学
东工	东北工学院
拒查	拒绝接受检查
健教	健康教育
中拆总公司	中国拆船总公司
北体	北京体育大学
青壮	青年壮年
控会	控制会议
语协	语言文字工作者协会
上科院	上海科学院
邮识	邮票常识
探子	探望儿子
技委	技术委员会
心梗	心肌梗塞
商调	协商调动
市话局	市区电话局
行警	银行警卫
科教会	科学教育指导委员会
班委	班级委员会委员
清左	清除左倾路线影响
一炼钢	第一炼钢厂
干修班	干部进修班
扩兵	扩充兵源
银监处	香港银行业监理处
黑白电视	黑白电视接收机
保密委	保密委员会
文管办	文化市场管理办公室
先租后股	先租赁后股份
评审	评定审查
化物所	化学物理研究所
北京人艺	北京人民艺术剧院
统派购	统一派购
田锦赛	田径锦标赛
流调	流动调查
中评委	国民党中央评议委员
街委	街道委员会
冷项	冷门项目
院党办	院党委办公室
上滑	上海滑稽剧团
鞍钢	鞍山钢铁公司
违宪	违反宪法
清粪	清除粪便
漂脸	漂白脸面皮肤
孤寡老	孤儿寡妇和老人
建机厂	建筑机械厂
扩增	扩大与增加
裁撤	裁减撤消
人均	每人平均
濒危	濒临灭绝的危险
师专	师范专科学校
亚非拉	亚洲非洲和拉丁美洲
上医大	上海医科大学
图联	国际图书馆协会联合会
非标	非标准化
经商	经营商业
供销社	供销合作社
治污	治理污染
康体	康乐体育
义诊	义务诊治
视协	电视艺术家协会
速算	快速计算
深港	深圳和香港
干政	干预政事
广府	广州政府
中国舞协	中国舞蹈家协会
文明办	精神文明建设办公室
左翼记联	中国左翼新闻记者联盟
吉化	吉林化学工业公司
筹办	筹备举办
市署	香港市政事务署
一商	第一商业局
地建商会	香港地产建设商会
果科所	果树科学研究所
名记	著名记者
温邪	温热之邪
解禁	解除禁令
英荷	英国荷兰
助查	协助调查
压编	压缩编制
参储	参加储蓄
壁总	香港壁球总会
庭期	开庭日期
科普片	科学普及影片
财金	财政金融
派红	派发红利
中控室	中央控制室
培蓄	培养和储蓄
窗式空调	窗式空气调节器
人武部	人民武装工作部
舞团	舞蹈艺术团
围协	围棋协会
航炮	航空机关炮
日俘	日本战俘
藏医	藏族医学
传习所	传授技艺的讲习所
男配	男配角
中国手协	中国手球协会
联防办	治安联合防治办公室
民航	中国民用航空公司
难侨	难民华侨
农电工	农村电工
蔬菜所	蔬菜种植研究所
亚太经合会	亚洲太平洋经济合作会议
残困户	残疾人困难户
掌理	掌握管理
普获	普遍获得
中仪	中国仪器进出口总公司
经理办	经理办公室
精神文明办	精神文明建设办公室
疗效	医疗效果
银膜	银光塑料薄膜
执监	执行委员会和监察委员会
民爆	民用爆破
恒指	香港恒生股票价格平均指数
反毒	反对毒品
货检	货物检验
胸透	胸部透视
冲关	冲破关卡
化纤布	化学纤维布
打非	打击非法出版物活动
心战科	心理作战科
劳动法主体	劳动法律关系主体
招选	招聘选拔
打砸抢抄抓	打人砸东西抢财物抄家抓人
辽沈	辽宁沈阳
重大	重庆大学
索贿	索取贿赂
企务	企业事务
投工	投入人工
中东和谈	中东和平谈判
星联	星际联盟
海缆	海底电缆
粮站	粮油管理站
寿险	人寿保险
供产销	供应生产和销售
舞星	舞蹈明星
劳保	劳动保护
军警	军队警察
二汽	第二汽车制造厂
防修	防止修正主义
企登科	企业登记科
聚赌	聚众赌博
家教	家庭教育
统购统销	统一收购和统一销售
巴黎公约	保护工业产权巴黎公约
员工	职员和工人
人劳局	人事劳动局
兰办	八路军兰洲办事处
中国医科院	中国医学科学院
定存	定期存款
研审	研究审查
老委会	老龄委员会
航博会	航空博览会
群防站	群众防病治病服务站
查私	查封走私案件
破产人	破产债务人
飞播	飞机播种
测土	测量土地
索赔	索取赔偿
统测	统一测试
日谍	日本谍报人员
机修厂	机械修配厂
民先队	中国民族解放先锋队
市政府办	市政府办公室
粮援	粮食援助
妇运	妇女运动
赛地	比赛地点
创设	创建设立
成电	成都电讯工程学院
粮科所	粮食科学研究所
商展	商品展览
科技文卫	科学技术文化卫生
史展	历史展览
边检人员	边防检疫人员
经改委	经济体制改革委员会
中企	中国国有企业
地导弹	地对地导弹
外次	外交部次官
污水厂	污水处理厂
渔工商	渔业工业和商业
财大	财经大学
警亭	警察执勤岗亭
税干	税务干部
械弹	枪械与弹药
技交	技术交易
邮编	邮政编码
征管查	征收管理检查
中促会	中国对外应用技术交流促进会
党史办	党史办公室
一汽	长春第一汽车制造厂
物调	物资调剂
医工所	医药工业研究所
电解液	电解质溶液
方尺	平方英尺
楼堂馆所	办公大楼礼堂宾馆和招待所
协勤	协助勤务
函大	函授大学
宿生	寄宿的学生
先登	首先登场
汽旅公司	出租汽车旅游公司
贫九	贫困地区九年义务教育
鼓煽	鼓吹煽动
煤质	煤炭质量
芭科	芭蕾舞科
人劳司	人事劳动司
哈白猪	哈尔滨白猪
统管	统一管理
国术界	中国武术界
省府	省政府
农讲所	农民运动讲习所
机耕	机械化耕作
办复	办理并答复
女柔	女子柔道
核资	核实资金
四大	第四次全国代表大会
省编委	省编制委员会
僧尼	僧人和尼姑
抗老	抵抗衰老
择业	选择职业
督察办	监督检察办公室
合营企业	中外合资经营企业
总支书	中共总支部书记
政民	政府和人民
特刑小分队	特种刑警小分队
普种	普遍接种
图博	图书馆和博物馆
侦技	侦察技术
农船	农业用船
防台	防御台风
怠忽	懈怠玩忽职守
市人委	市人民委员会
审执	审理执行
世足赛	世界杯足球赛
欧足赛	欧洲足球锦标赛
南昆	南方昆曲
影圈	电影圈
科诨	插科打诨
校秩部	学校秩序部
冬训	冬季训练
专委会	专门委员会
粮农	粮食农业
补种	补行接种
北约	北大西洋公约组织
农险	农业保险
中制公司	中国电影合作制片公司
联共	联合共产党
减肥	减轻肥胖程度
电业	电力工业
潮人	潮洲人
空调器	空气调节器
哈军工	哈尔滨军事工程学院
浙大	浙江大学
建安	建筑和安装
亲共	亲近共产党
联抗	联合抗日部队
台澎金马	台湾澎湖金门马祖诸岛
农林水产	农业林业水产
上师大	上海师范大学
训委会	训育委员会
长城卡	长城信用卡
吧台	酒吧台
五大	中国共产党第五次全国代表大会
遗传所	遗传研究所
采编人员	采访编辑人员
英超	英国超级联赛
叙军	叙利亚军队
幼专	幼儿师范专科学校
商流	商品流通
语用所	语言文字应用研究所
四城会	第四届城市运动会
南开	南开大学
稽察	稽查检察
特嫌案	特务嫌疑案件
临工	临时工
冬麦	越冬小麦
函询	用信函询问
公校	公办学校
汽贷	汽车贷款
编校	编辑校对
贩安	贩售安非他命
泰华作家	泰国华文作家
省直	省委和省政府直属机关
经发组织	经济合作和发展组织
险房	危险房屋
电灌	电力排水灌溉
央视	中央电视台
反贪	反对贪污
徐铁	徐州铁路局
增谊	增进友谊
旅游局	旅游事业管理局
订颁	制订并颁布
国税局	国家税务局
联合国安理会	联合国安全理事会
区调	区域地质调查
生活费指数	职工生活费用价格指数
油国	石油出口国
南工大	南京理工大学
战略办	战略办公室
马会	皇家赛马会
食市	食品市场
环卫所	环境卫生所
高师	高等师范
解困办	解决居民住房困难办公室
柬通社	柬埔寨通讯社
哥大	哥伦比亚大学
房源	住房来源
征稽	征收稽查
化废	化学废物
首拍	首次拍卖
肌注	肌肉注射
城工	城市工作
评优	评选优秀
货车成本	货车运输成本
少体	少年体育
军停会	朝鲜军事停战委员会
中新社	中国新闻社
专署	专员公署
影视记协	电影电视记者协会
中信	中国国际信托投资公司
经建会	经济建设委员会
工效	工作效率
农建委	农业建设委员会
烈属	烈士家属
技研会	科学技术研究会
国政系	国际政治系
足锦赛	足球锦标赛
金贸	黄金贸易
科技教界	科学技术教育界
反殖	反对殖民主义
企管办	企业管理办公室
津城	天津城
安大	安徽大学
在职教	在职教育
函校	函授学校
冶工部	冶金工业部
8中	第88中学
显效	显著效果
集体办	集体事业办公室
货币战	货币战争
妥慎	妥善和谨慎
汽齿厂	汽车齿轮厂
生资	生产资料
边民	边境居民
罗政	罗马尼亚政府
名特新优	名牌产品特产产品新品优质产品
高企	高技术企业
工调	工资调整
三轮卡	三轮卡车
扫黄	扫除黄色淫秽活动
私小	私立小学
二级站	二级采购供应站
法工委	法制工作委员会
反修	反对修正主义
钓手	钓鱼选手
轮候	轮流等候
译训班	翻译人员训练班
脱密	脱离机密
华校	华侨学校
分流比	分流比例
追缉	追查缉拿
兵工部	兵器工业部
表委会	表演艺术委员会
监委会	监督委员会
港澳办	港澳事务办公室
科普协会	科学技术普及协会
建材局	建筑材料工业局
崇外	崇文区外
中外运公司	中国外贸运输公司
强震	强烈地震
国际舞	国际标准舞
社文委	社会文化委员会
世界青联	世界民主青年联合会
空乘	航空乘务
痕检	痕迹检验
农修厂	农业机械修配厂
钢研所	钢铁研究所
关停并转破	关闭停产兼并转产和破产
足总杯赛	英格兰足球总会杯赛
亚太区	亚洲太平洋地区
惩腐倡廉	惩治腐败提倡廉政
和谈	和平谈判
采运	采摘运输
局封	局部封闭疗法
农信联社	农村信用联社
长三甲	长征三号甲
台视	台湾电视中心
文白	文言和白话
文体卫	文化体育卫生
广影厂	广州电影制片厂
垦荒	开垦荒地
聋校	聋哑学校
机电办	机械电子工业办公室
编印	编写印制
探空	探测太空
抄方	抄写药方
军干所	军队干部休养所
生产社	农业生产合作社
用电办	用电办公室
自导自演	自己导演自己扮演
区直	区直属机关
美资	美国资金
农建工地	农田基础水利建设工地
清舱	清理机舱
杂协	中国杂技艺术家协会
少共	中国少年共产党
海监	海上安全监督
基协	中国基督教协会
仓储	仓库储存
菊展	菊花展览
组导处	组织领导处
实操	实际操作
上京	上海京剧院
法政	法律和政治
普文	普通文科
工时	工作时间
乒赛	乒乓球比赛
土管所	土地管理所
肃反	肃清反革命
引资	引进资金
滑筝协会	滑翔风筝协会
体专班	体育专修班
西文	西方文字
清大	台湾清华大学
文专协	香港文职及专业人员协会
账委会	香港政府账目委员会
访演	访问演出
侨校	华侨学校
东盟记联	东盟国家记者联合会
煤炭部	煤炭工业部
淮委会	治淮委员会
增资增资	增加工资增加资本
棉花所	棉花研究所
外汇券	外汇总换券
夏秋	夏季秋季
辽大	辽宁大学
实控线	实际控制线
预议	预先评议
大桥局	大桥建设工程局
贸促会	中国国际贸易促进委员会
高评委	高级专业人员职称评定委员会
二六车	二十六英寸自行车
深交所	深圳证券交易所
储种	储蓄种类
文工会	文化工作委员会
和黄	香港和记黄埔有限公司
建委会	基本建设委员会
增建	增加建立
实龄	实足年龄
接尘	接触尘埃
羽联	羽毛球联合会
网总	香港网球总会
台股	台湾股票
编导	编剧和导演
政办	政府办公室
土化	土壤化学
招募办	招募办公室
总办	总办事处
社保基金	社会保险基金
代营	代为经营
国银	国际清算银行
拒贿	拒绝收受贿赂
控辩	控告辩护
医卫组	医疗卫生组
现反	现行反革命
男乒	男子乒乓球
众院	众议院
直资	直接资助
运距	运输距离
七机部	第七机械工业部
中考	初中毕业生升学考试
戒护	警戒与维护
军委会	军事委员会
动物所	动物研究所
上粮所	上海粮食交易所
普快	普通旅客快车
新币	新加坡货币
水安公司	水利建筑安装公司
中工	台湾中华工程公司
阿以	阿拉伯和以色列
图文	图像和文字
群体处	群众体育处
贸展会	贸易展览会
展贸	展览贸易
微画	微型绘画
体师院	体育师范学院
京郊	北京市郊区
摩联	摩托车联合会
规限	规定与限制
验资	检验资金
总账	总分类账簿
申奥	申办奥运会
基训	基本训练
化机	化学工业机械
抗跌	抗拒下跌
实训	实验和培训
一毛	第一毛纺织厂
拔荐	提拔举荐
纤颤	肌纤维颤抖
春灌	春季灌溉
立例	制定确立法规案例
非欧	非洲欧洲
守时	遵守时间
化工	化学工业
亚记联	亚洲记者联盟
趋贬	趋于贬值
城调队	城市调查队
剧联	中国左翼戏剧家联盟
参演	参加演出
忠救军	忠义救国军
飞行队	飞行服务队
壮乡	壮族自治乡
售粮储蓄	优待售粮定期定额储蓄
配额	分配的定额
农机校	农业机械学校
意共	意大利共产党
童房	儿童睡房
上海艺大	上海艺术大学
国科大	国防科技大学
中财委	中央财政经济委员会
西救	西北各界抗日救国联合会
温控	温度控制
广院	北京广播学院
缓建	延缓建设
探慰	探望和慰问
书画影戏	书法绘画电影戏剧
人寿险	人寿保险
中国印协	中国印刷技术协会
图工委	图书情报工作委员会
泳后	游泳皇后
展筑	铺展修筑
绒癌	绒毛膜癌
农科院	农业科学研究院
管养段	管理和养护地段
农行	中国农业银行
科交会	科技成果交易会
铁十九局	铁道部第十九工程局
建总	城建总公司
北广	北京广播学院
农林水牧	农业林业水利牧业
广电	广播与电视
肃奸	肃清汉奸
