筹资	筹集资金
脱险	脱离危险
摘金	摘取金牌
复健	恢复健康
复交	恢复外交关系
断交	断绝外交关系
购股	购买股票
修宪	修改宪法
搜证	搜集证据
审案	审理案件
从商	从事商业
减资	减少资本
反战	反对战争
触法	触犯法律
增收	增加收入
驾机	驾驶飞机
补税	补交税款
受托	接受委托
增税	增加税收
运毒	运送毒品
防台	防御台风
联共	联合共产党
参演	参加演出
节水	节约用水
留美	留学美国
增编	增加编制
换俘	交换俘虏
抬价	抬高价格
援藏	支援西藏
治污	治理污染
扩招	扩大招生
治淮	治理淮河
引资	引进资金
引智	引进国外智力
参赌	参加赌博
执纪	执行纪律
反帝	反对帝国主义
判监	判处监禁
增支	增加支出
平叛	平息叛乱
评优	评选优秀
投运	投入运行
组工	组织工作
调资	调整工资
纠风	纠正行业不正之风
帮贫	帮助贫困户
评先	评选先进
普九	普及九年制义务教育
减亏	减少亏损
管城	管理城市
治黄	治理黄河
采标	采用国际标准和国外先进标准
私烟	走私香烟
重教	重视教育
推普	推广普通话
打私	打击走私活动
治太	治理太湖