正选	正式选举
粮播	粮食播种
马约	马斯特里赫特条约
消联	消费者联合会
中心馆	中心图书馆
跳雪	跳台滑雪
北师大	北京师范大学
行政庭	行政审判庭
复健	恢复健康
工业所	工业经济研究所
建照	建筑执照
经联会	经济联合会
价改	价格改革
禁用	禁止使用
男板	男子跳板跳水
铁总	铁路总工会
横联	横向联合
粮菜	粮食和蔬菜
影馆	电影馆
职灾	职业灾害
军情	军事情报
陶艺	陶瓷艺术
调研	调查研究
经济庭	经济审判庭
建材	建筑材料
增收	增加收入
北平艺专	北平艺术专科学校
沈铁	沈阳铁路局
节支	节约开支
暨大	暨南大学
组派	组织派遣
中直	中央直属机关
射距	射击距离
扶残	扶助残疾人
美协	美术家协会
控申	控告申诉
旅团	旅行团
普中	普通中学
兵总	兵器工业总公司
植检	植物检疫
边城	边境城市
免诉	免予起诉
协处	协助处理
巨资	巨额资金
中央工艺美院	中央工艺美术学院
违诺	违反承诺
政院	政治学院
海洋所	海洋研究所
影本	电影剧本
时流	时代潮流
拉美经委会	拉丁美洲和加勒比经济委员会
化奥	化学奥林匹克竞赛
劳保所	劳动保护科学研究所
植化	植物化学
家教会	家庭教育研究会
普训	普及培训
工总	工业总会
企管部	企业管理部
绍酒	绍兴酒
人教司	人事教育司
计办	计划办公室
长汽	长春第一汽车制造厂
创演	创作和演出
劣品	劣质商品
防总办	防汛总指挥部办公室
围殴	围攻殴打
前指	前线指挥部
边检站	边防检查站
建署	香港建筑署
技改	技术改造
留美	留学美国
地勘	地质勘查
邮工	邮政工会
钓协	钓鱼协会
艺协	艺术家协会
增幅	增长幅度
律考	律师考试
自动线	自动生产线
司训	司机训练
静点	静脉点滴
男单	男子单打
严控	严格控制
引智	引进国外智力
有机所	有机化学研究所
婚龄	结婚年龄
港股	香港股市
国际柔联	国际柔道联合会
个贷	个人贷款
教科院	教育科学研究院
赛项	比赛项目
标样	标准样品
实小	实验小学
分获	分别获得
世俱赛	世界俱乐部赛
工经	工业经济
道协	道教协会
厂商会	香港中华厂商联合会
棉办	棉花办公室
硕导	硕士生导师
初小	初级小学
保队	保加利亚队
节水	节约用水
名址	姓名和地址
参拍	参加拍摄
日皇	日本天皇
续贬	继续贬值
车管	车辆管理
一纵	第一纵队
陆积	陆地面积
长话线	长途电话线
自研	自行研制
职总	职工总会
工美	工艺美术品
农办	农业办公室
普高	普通高级中学
劳防	劳动防护
长输	长途运输
铁四院	铁道部第四勘测设计院
市容委	市容管理委员会
国家防总	国家防汛抗旱总指挥部
料耗	材料消耗
玉烟	云南玉溪卷烟厂
剧评	戏剧评论
审期	审理期限
人委	人民委员会
世俱杯	世界俱乐部杯
军转工作	军队转业干部安置工作
晤商	会晤协商
诉案	诉讼案
广涉	广泛涉及
外经贸	对外经济贸易
学代会	学生代表大会
光机所	光学精密机械研究所
奥校	奥林匹克学校
刑侦	刑事侦查
乙脑	乙型脑炎
换俘	交换俘虏
长发公司	长江经济联合发展股份有限公司
推普	推广普通话
轻卡	轻型卡车
还贷	偿还贷款
工业废物	工业固体废物
农大	农业大学
公汽公司	公共汽车公司
贪案	贪污案件
武委	武术委员会
青工部	青年工作部
深房	深圳住房
北昆	北方昆曲
拳总	拳击总会
体疗	体育医疗
支边	支援边疆
汽修厂	汽车修理厂
残工委	残疾人工作委员会
普九	普及九年制义务教育
妇委会	妇女委员会
应化所	应用化学研究所
机院	机械学院
二外	第二外国语学院
师培	师资培训
澳姐	澳门小姐
世青赛	世界青年锦标赛
农职校	农村职业学校
纺机	纺织机械
铅排	铅字排版
调资	调整工资
名导	著名导演
外汇局	外汇管理局
宪草	中华人民共和国宪法草案
煤机厂	煤矿机械厂
新例	新条例
土改	土地改革
援藏	支援西藏
三棉	第三棉纺织厂
治保	治安保卫
佛协	佛教协会
冰联	冰球联合会
菌痢	细菌性痢疾
戏研	戏剧研究
女举	女子举重
机电部	机械电子工业部
搜毒	搜查毒品
改危	改造危房
滥权	滥用职权
上财	上海财经大学
非工统	非洲工会统一组织
国际共运	国际共产主义运动
个调税	个人收入调节税
央航	中央航空公司
经协办	经济协作办公室
新航	新加坡航空公司
退约	退出条约
南共体	南部非洲发展共同体
临管会	临时管理委员会
医研	医学研究
家财	家庭财产
完中	完全中学
警号	警示信号
城建	城市建设
舞美	舞台美术
参赌	参加赌博
煤科	煤炭科学
心防	心理防线
南侨	南洋华侨
制博会	装备制造业博览会
教参	教学参考资料
盲流	盲目流动
中芭	中央芭蕾舞团
中控	中央控制
成飞	成都飞机
考纲	考试大纲
基民党	基督教民主党
附中	附属中学
整党	整顿党风
停播	停止播放
牙防	牙病防治
登联	登山联合会
访京	访问北京
计经委	计划经济委员会
长航	长江航运
南太地区	南太平洋地区
录干	录用干部
重审	重新审查
亚羽联	亚洲羽毛球联合会
戏文系	戏剧文学系
普初	普通初中
青运史	青年运动史
人防	人民防空
农研室	农村政策研究室
台大	台湾大学
体改司	体制改革司
纪监	纪律监督
评文	评论文章
管输	管道输送
机校	机械学校
劳模	劳动模范
集游法	集会游行法
重百	重庆百货
军力	军事力量
国际航联	国际航空运动联合会
宣导	宣传引导
仓管员	仓库管理员
安检	安全检查
公屋	公共房屋
文保	文物保护
科技社	科学技术出版社
激辩	激烈争辩
乌市	乌鲁木齐市
未保委	未成年人保护委员会
青协	青年协会
防疟	防治疟疾
国贸	国际贸易
参院	参议院
脊灰	脊髓灰质炎
排协	排球协会
读博	攻读博士学位
工体	北京工人体育场
自防	自身防范
日经联	日本经营者团体联盟
福铁	福州铁路
长话	长途电话
费负	费用负担
运能	运输能力
石化厅	石油化学工业厅
妇检	妇科检查
网协	网球协会
民诉	民事诉讼
铁五局	铁道部第五工程局
自民	自由民主
泳手	游泳选手
抽佣	抽取佣金
专储	专项储备
购股	购买股票
地空导弹	地对空导弹
机译	机器翻译
红高	红色高棉
厦大	厦门大学
公意	公民意愿
科考队	科学考察队
军机	军事机密
心外科	心血管外科
总工会	中华全国总工会
华东师大	上海华东师范大学
矿管局	矿产资源管理局
军干	军队干部
国开行	国家开发银行
上工	上海工业
警校	警察学校
设陷	设置陷阱
邮储	邮政储蓄
外航	外国航空公司
世运会	世界运动会
梅剧团	梅兰芳剧团
关员	海关人员
降损	降低损耗
女乒	女子乒乓球队
长管	长期管理
工发组织	联合国工业发展组织
冰啤	冰镇啤酒
亚乒	亚洲乒乓球
港报	香港报纸
昆虫所	昆虫研究所
触法	触犯法律
伊协	伊斯兰教协会
童军	童子军
社科系	社会科学系
校董会	学校董事会
食协	食品工业协会
受教	接受教育
届退	届龄退休
发股	发行股票
中央美院	中央美术学院
参编	参加编写
治太	治理太湖
吧女	酒吧女郎
滞港	滞留香港
联汇制	联系汇率制度
矿机厂	矿山机器厂
产需	生产需求
国际铁联	国际铁人三项联合会
阿语	阿拉伯语
牌告	挂牌公告
民贸	民族贸易
统战	统一战线
亚锦赛	亚洲锦标赛
学额	学生名额
粮价	粮食价格
财长	财政部部长
索费	索取费用
工产	工业生产
内处	内部处理
顾委	顾问委员会
校护	学校护士
班厦	班达拉奈克国际会议大厦
时限	时间限制
农工委	农村工作委员会
国际箭联	国际射箭联合会
65中	第65中学
社改	社会改革
国家体改委	国家经济体制改革委员会
世协	世界语协会
首体	首都体育馆
路局	铁路局
音效	音响效果
交委	交通委员会
青保	青少年保护
教研	教学研究
立审	立案审查
支扩	支气管扩张
交大	交通大学
贪贿	贪污和受贿
邮运	邮政运输
劳技课	劳动技术课
月均	每月平均
年运量	年运输量
政工	思想政治工作
泳联	游泳联合会
失忆	失去记忆
数显	数字显示
研考	研究生入学考试
监检	监察和检察
脱贫	摆脱贫困
高专	高等专科学校
包商	承包商
停售	停止销售
运邮	运送邮件
扩招	扩大招生
二轻局	第二轻工业局
曲联	曲棍球联合会
声学所	声学研究所
科协	科学技术协会
政争	政治斗争
解阵党	解放阵线党
社保费	社会保险费
民族宫	北京民族文化宫
空运	航空运输
特支	特别支部
十届	第十届
控检	控制检查
普内	普通内科
教联会	香港教育工作者联会
港岛	香港岛
北视	北京电视艺术中心
关工委	关心下一代工作委员会
增支	增加支出
二次大战	第二次世界大战
体事	体育赛事
亚举联	亚洲举重联合会
译协	翻译工作者协会
青训	青年培训
银系	银河系
商交所	商品交易所
军控	军备控制
空爆	空中爆炸
沪办	驻沪办事处
钱江	钱塘江
公审	公开审判
羽协	羽毛球协会
夏奥会	夏季奥林匹克运动会
少儿基金会	少年儿童基金会
工改	工资制度改革
壁饰	墙壁装饰
广协	广告协会
女师	女子师范学校
参试	参加试验
交通量	交通流量
刑事技术	刑事科学技术
狱务	监狱事务
附小	附属小学
学具	学习用具
产供	生产供应
二机部	第二机械工业部
纪检委	纪律检查委员会
油市	石油市场
严斥	严厉斥责
法改会	香港法律改革委员会
农研所	农业科学研究所
高研班	高级研讨班
钢研	钢铁研究
春管	春季田间管理
普客	普通旅客列车
僚气	官僚习气
委管	委托管理
微生物所	微生物研究所
铁十一局	铁道部第十一工程局
舞校	舞蹈学校
时控	时间控制
消保法	消费者保护法
数学所	数学研究所
老慢支	老年慢性支气管炎
镇反	镇压反革命
民乐	民族音乐
排管	排水管道
职中	职业中学
男双	男子双打
博协	博物馆协会
球卡	球员卡
沈大	沈阳大学
版协	出版协会
专校	专科学校
童装	儿童服装
二产	第二产业
社盟	社会联盟
工大	工业大学
陆校	陆军学校
渔捞	渔业捕捞
败因	失败原因
马航	马来西亚航空公司
国际举联	国际举重联合会
学优	学习成绩优异
环保科研所	环境保护科学研究所
世行	世界银行
二商局	第二商业局
支乡	支援家乡
成教	成人教育
纺企	纺织企业
联交所	香港联合交易所
受阅	接受检阅
北京体院	北京体育学院
世锦赛	世界锦标赛
金管局	香港金融管理局
联校	联合学校
组训	组织训练
农调队	农村社会经济调查队
农资	农业生产资料
城巴	城市巴士
女泳	女子游泳
拥吻	拥抱和亲吻
亚武联	亚洲武术联合会
越战	越南战争
脱险	脱离危险
宋瓷	宋代瓷器
林科院	林业科学院
编务	编辑业务
莎剧	莎士比亚戏剧
计免	计划免疫
现值	现实价值
乒协	乒乓球协会
内审	内部审计
中运会	中学生运动会
职高生	职业高中学生
少儿社	少年儿童出版社
报备	申报备案
临客	临时旅客列车
铁三局	铁道部第三工程局
远教	远距离教育
三机部	第三机械工业部
画艺	绘画艺术
公交	公共交通
老体协	老年人体育协会
停检	停车检查
商运	商业运输
长影	长春电影制片厂
首师大	首都师范大学
经委	经济委员会
儿艺	儿童艺术
军检	军事检察院
伊通社	伊拉克通讯社
民运会	少数民族运动会
内控	内部控制
尼共	尼泊尔共产党
东汽	东风汽车公司
纪委会	纪律委员会
协寻	协助寻找
祭仪	祭奠仪式
军体	军事体育
多经	多种经营
民管会	民主管理委员会
帮理	帮助料理
智残	智力残疾
林大	林业大学
普六	普及六年制义务教育
车市	汽车市场
储贷	储蓄和贷款
季检	季度检查
商誉	商业信誉
大本	大学本科
剖验	解剖检验
荣军	荣誉军人
复交	恢复外交关系
基干	基层骨干
社店	出版社和书店
采标	采用国际标准和国外先进标准
高知	高级知识分子
伏休	伏季休渔
日铁	日本铁路
产加销	生产加工销售
私烟	走私香烟
医界	医疗界
拥塞	拥挤堵塞
基社盟	基督教社会联盟
专才	专业人才
宣教部	宣传教育部
民自党	民主自由党
善信	善男信女
上交所	上海证券交易所
火电站	火力发电站
制播	制作和播出
雕艺	雕刻艺术
污控司	污染控制司
车险公司	汽车保险公司
排联	排球联合会
续降	继续下降
质监	质量监督
利废	利用废物
质管部	质量管理部
区计委	区计划委员会
国家工商局	国家工商行政管理局
葬仪	安葬仪式
区府	市辖区人民政府
河界	楚河汉界
证交税	证券交易税
经团联	日本经济团体联合会
共盟	共产主义者联盟
农贷	农业贷款
禁销	禁止销售
控温	控制温度
七运会	第七届全国运动会
香港教联	香港教育工作者联合会
北方交大	北方交通大学
珠影	珠江电影制片厂
特困	特殊困难
军管会	军事管制委员会
乒总	乒乓球总会
港警	香港警察
中纪委	中央纪律检查委员会
经适房	经济适用房
品改	品种改良
音教	音乐教育
星箭	卫星和火箭
胆石	胆囊结石
解纷	解决纷争
妇工委	妇女工作委员会
潜亏	潜在亏损
书家	书法家
黄带	黄色录像带
合作企业	中外合作经营企业
招委	招生委员会
安盟	争取安哥拉彻底独立全国联盟
招飞	招收飞行学员
农改	农业改革
特训	特别训练
渔技	渔业技术
安保部	安全保卫部
市办	市委办公室
南工团	南下工作团
市务	市场业务
机电署	机电工程署
执纪	执行纪律
质保	质量保证
化脑	化脓性脑膜炎
慢萎	慢性萎缩性胃炎
运毒	运送毒品
物理所	物理研究所
宪警	宪兵和警察
外联处	对外联络处
游将	游泳健将
财困	财政困难
棉产	棉花生产
拒收	拒绝接收
药化	药物化学
保定军校	保定军官学校
房津	房屋津贴
铁十五局	铁道部第十五工程局
轮涨	轮番上涨
增干	增加干部
边贸	边境贸易
运管费	运输管理费
办展	举办展览
首旅	首都旅游
安莎社	安莎通讯社
经管	经济管理
波幅	波动幅度
文班	文科班
羽总	香港羽毛球总会
射联	射击联合会
国际拳联	国际业余拳击联合会
国际手联	国际手球联合会
足校	足球学校
马岛	马尔维纳斯群岛
乐疗	音乐治疗
印尼	印度尼西亚
支铁	支援铁路建设
约通社	约旦通讯社
再障	再生障碍性贫血
维园	香港维多利亚公园
粮贸	粮食贸易
村助	村长助理
评先	评选先进
民院	民族学院
产能	生产能力
货代	货物运输代理
放贷	发放贷款
普教	普通教育
食油	食用植物油
津沽	天津塘沽
企管处	企业管理处
尸表	尸体表面
心内科	心血管内科
节电	节约用电
无照	无牌照
南师	南京师范大学
展交会	展览交易会
国基	国家基础
妇委	妇女委员
物交会	物资交易会
展馆	展览馆
外片	外国影片
访摄	采访拍摄
政团	政治团体
学平险	学生平安保险
韩食	韩国食品
软网	软式网球
反帝	反对帝国主义
地矿局	地质矿产局
技联	技巧联合会
空司	空军司令部
海练	海上训练
一棉厂	第一棉纺织厂
科仪	科学仪器
寸照	一寸照片
欧陆	欧洲大陆
摩配	摩托车配件
能委	能源委员会
篮协	篮球协会
长防林	长江防护林
工研院	工业研究院
统整	统一整合
嫌犯	嫌疑犯
上港	上海港务局
生化	生物化学
无核国	无核武器国家
矿大	矿业大学
筹资	筹集资金
流脑	流行性脑脊髓膜炎
群文	群众文化艺术
展洽会	展览洽谈会
化救	化学事故应急救援
电子局	电子工业局
补校	补习学校
经援	经济援助
规管	规划管理
拖厂	拖拉机制造厂
彩印	彩色印刷
一附中	第一附属中学
影评	电影评论
锡盟	锡林郭勒盟
私宅	私人住宅
劳动人口	劳动年龄人口
建商	建筑商
街居	街道居民
刑案	刑事案件
保盟	保卫中国同盟
职棒	职业棒球
节耗	节约能耗
国际世协	国际世界语协会
铁一院	铁道部第一勘测设计院
轻轿	轻型轿车
上博	上海博物馆
村企	村办企业
农函大	农业函授大学
城改	城市改造
续任	继续留任
抛股	抛售股票
监委	监察委员会
启导	启发引导
史著	历史著作
卫技	卫生技术
高息	高额利息
电镜	电子显微镜
蒙通社	蒙古通讯社
开发协会	国际开发协会
环卫	环境卫生
人口老化	人口老龄化
局麻	局部麻醉
成棒	成人棒球
市况	市场状况
环保部	环境保护部
技协	技术协会
计财部	计划财务部
动源	动力源
表抗	乙型肝炎表面抗原
现势	现实形势
审案	审理案件
热作	热带作物
勒赎	勒索赎金
甲减	甲状腺功能减退
委培	委托培养
六运会	第六届全国运动会
私物	私人物品
投洽会	投资洽谈会
叙通社	叙利亚通讯社
西南交大	西南交通大学
党史	党的历史
短网	短式网球
二棉	第二棉纺织厂
乡建	乡村建设
军管	军事管制
武协	武术协会
23中	第23中学
欧鳗	欧洲鳗
海司	海军司令部
科艺	科学和艺术
业校	业余学校
考纪	考试纪律
北邮	北京邮电大学
经改	经济体制改革
消保会	消费者保护协会
伊航	伊拉克航空公司
举联	举重联合会
城工部	城市工作部
企财	企业财产
林型	森林类型
世局	世界局势
作代会	作家代表大会
辽吉	辽宁吉林
电联	国际电信联盟
总台	总服务台
联汇	联系汇率
一产	第一产业
合同工	合同制工人
反和	反对和平
鲜蔬	新鲜蔬菜
统供	统一供应
政研室	政策研究室
科委会	科学研究委员会
二十三中	第二十三中学
投信公司	投资信托公司
专控	专项控制
农居	农转居
军代表	解放军代表
医科院	医学科学院
海湾合作委员会	海湾阿拉伯国家合作委员会
公惩会	公务员惩戒委员会
女单	女子单打
外宣	对外宣传
住房改革	住房制度改革
夏训	夏季训练
救孤	救助孤儿
技物所	技术物理研究所
严处	严肃处理
鲁博	鲁迅博物馆
检法	检察院和法院
高干	高级干部
劳动市场	劳动力市场
陆架	大陆架
白兰花	白玉兰花
摘金	摘取金牌
客量	客流量
二十二中	第二十二中学
内潜	内部潜力
飞安	飞行安全
抗战	抗日战争
养教	培养教育
市经	市场经济
政技	政治和技术
毛选	毛泽东选集
枪匪	持枪匪徒
唐院	唐山铁道学院
国际民航组织	国际民用航空组织
军训	军事训练
防保	预防保健
人口所	人口研究所
优分	优先分配
环委会	环境保护委员会
女板	女子跳板跳水
儿基会	儿童少年基金会
北展	北京展览馆
经技	经济与技术
扫盲	扫除文盲
铁四局	铁道部第四工程局
商银	商业银行
一机部	第一机械工业部
农院	农业学院
台胞	台湾同胞
共建	共同建设
儿麻	小儿麻痹症
内刊	内部刊物
社科司	社会科学司
大核	大亚湾核电站
共集	共同筹集
汤杯赛	汤姆斯杯赛
公德	公共道德
体模	人体模型
携械	携带枪械
世贸	世界贸易
美院	美术学院
迎检	迎接检查
青企协	青年企业家协会
科研	科学研究
乒联	乒乓球联合会
棉检	棉花检验
瑞航	瑞士航空公司
邮费	邮政资费
财校	财政学校
健检	健康检查
举协	举重协会
专干	专职干部
铁一局	铁道部第一工程局
增编	增加编制
擅设	擅自设置
编采	编辑采访
完小	完全小学
城管办	城市管理办公室
林管局	林业管理局
青少部	青少年部
高铁	高速铁路
厨卫	厨房卫生
债息	债券利息
附院	附属医院
社署	香港社会福利署
海测	海洋测量
史语所	历史语言研究所
女足	女子足球
农房	农民住房
共军	共产党的军队
南农大	南京农业大学
环发大会	联合国环境与发展大会
巡讲	巡回演讲
七建	第七建筑公司
组工会	组织工作会
退管会	退休职工管理委员会
语训	语言训练
时空	时间和空间
校建	学校建设
祖国战线	祖国统一民主主义战线
贸工	贸易和工业
治黄	治理黄河
人大	人民代表大会
清债	清理债务
雪联	滑雪联合会
上感	上呼吸道感染
瑞郎	瑞士法郎
二商	第二商业
间选	间接选举
涉政	涉及政治
航图	航空图
产销	生产和销售
财委会	财政委员会
航校	航空学校
海监局	海上安全监督局
川府	四川政府
上海交大	上海交通大学
市运会	市运动会
义教	义务教育
增税	增加税收
汽渡	汽车轮渡
女中	女子中学
西航	西北航空公司
教科文卫委	教育科学文化卫生委员会
扬大	扬州大学
投运	投入运行
国际体联	国际体操联合会
保监处	保险业监理处
加姐	加拿大小姐
朝中社	朝鲜中央通讯社
建施	建设实施
考规	考试规则
黄陵	黄帝陵
控购	控制购买
医管会	医院管理学会
综保	综合保险
菲航	菲律宾航空公司
汽摩	汽车摩托车
主控	主要控制
农经	农业经济
彩照	彩色照片
广管局	香港广播事务管理局
崇美	推崇美国
速测	快速检测
林院	林学院
葡共体	葡语国家共同体
领海权	领海主权
民改	民主改革
医大	医科大学
纺织部	纺织工业部
花协	花卉协会
美展	美术作品展览
司干	司局级干部
防指	防汛抗旱指挥部
开行	开发银行
库管员	仓库保管员
治淮	治理淮河
乐评	音乐评论
货管	货物运输管理
飞运	飞机运输
施压	施加压力
男曲	男子曲棍球
支书	支部书记
结防	结核病防治
职初	职业初中
税警	税务警察
汽配	汽车配件
语委	语言文字工作委员会
工厦	工业大厦
腰穿	腰椎穿刺
北大	北京大学
机修	机械修理
景瓷	景德镇瓷器
血检	血液检测
时评	时事评论
文教	文化教育
主秘	主任秘书
氧割	氧气切割
上视	上海电视台
批供	批量供应
光电所	光电技术研究所
政校	政治学校
巡展	巡回展出
体校	体育学校
安钢	安阳钢铁公司
金饰	黄金首饰
阿航	阿根廷航空公司
计生户	计划生育户
职安	职业安全健康
防贪	防止贪污
篮联	篮球联合会
步校	步兵学校
克旗	克什克腾旗
亚青赛	亚洲青年锦标赛
校纪	学校纪律
党纪	党的纪律
农电	农村用电
国际羽联	国际羽毛球联合会
金交所	金融交易所
侗民	侗族人民
大三生	大学三年级学生
组宣部	组织宣传部
药监	药品监督
超模	超级模特
二十中	第二十中学
央行	中央银行
消大	消防大队
巴解组织	巴勒斯坦解放组织
计财司	计划财务司
炮校	炮兵学校
南队	南斯拉夫队
乡邮	乡村邮递
联柬机构	联合国驻柬埔寨临时权力机构
静息	安静休息
冰期	冰川时期
打私	打击走私活动
管城	管理城市
东协	东南亚国家协会
共荣	共同繁荣
环保	环境保护
艰困	艰难困苦
农广校	农业广播电视学校
临屋	临时房屋
战训	战备训练
户政	户籍政策
行人专区	行人专用区
协拍	协助拍摄
国新社	国际新闻社
五一节	五一国际劳动节
农高会	农业高新科技成果博览会
外事	外交事务
外经	对外经济
准购	批准购买
五交	五金交电
外文局	外文出版发行事业局
社劳青	社会主义劳动青年同盟
青工	青年工人
星战	星球大战
法学所	法学研究所
科国	科威特国
军援	军事援助
水科院	水利水电科学研究院
铁中	铁路中学
质控	质量控制
摩步	摩托化步兵
计生	计划生育
转风	转变作风
尿感	尿路感染
欧币	欧洲国家货币
上柴	上海柴油机厂
俄联邦	俄罗斯联邦
供市	供应市场
施才	施展才能
体语	身体语言
孔教	孔子教育
物耗	物资消耗
特使	特命全权大使
冰协	冰球协会
国家经委	国家经济委员会
女花	女子花剑
绿带	绿化地带
驾照	驾驶执照
冬交会	冬季交易会
港大	香港大学
群艺馆	群众艺术馆
退管	退休职工管理
非行	非洲开发银行
中东社	中东通讯社
高公局	高速公路管理局
卫校	卫生学校
世羽赛	世界羽毛球锦标赛
老龄委	老龄工作委员会
立局	立法局
环发	环境与发展
农技协	农业技术协会
空政	空军政治部
盒带	盒式录音带
环科所	环境科学研究所
节资	节约资金
民委	民族事务委员会
动检	动物检疫
民谚	民间谚语
知青	知识青年
省防指	省防汛指挥部
激光所	激光技术研究所
意航	意大利航空公司
副主委	副主任委员
国家语委	国家语言文字工作委员会
文艺界	文学艺术界
减让	减税让利
交管部门	交通管理部门
严罚	严肃处罚
工博会	工业博览会
放私	放纵走私
民曲	民间乐曲
无人机	无人驾驶飞机
亚排联	亚洲排球联合会
农地	农业用地
扩销	扩大销售
深弹	深水炸弹
海模	航海模型
能耗	能源消耗
沈后	沈阳军区后勤部
川大	四川大学
男花	男子花剑
港客	香港客商
物探	地球物理勘探
影带	录影带
文体广电局	文化体育广播电视局
手协	手球协会
社科	社会科学
议联	议员联盟
采供	采购供应
兰铁	兰州铁路
内销	国内销售
太钢	太原钢铁公司
优长	优点和长处
女双	女子双打
森防	森林防护
免刑	免予刑事处分
加榴炮	加农榴弹炮
加幅	增加幅度
农运	农民运动
医工	医务工作者
艺校	艺术学校
工企	工业企业
农化	农业化学
林校	林业学校
责编	责任编辑
社保	社会养老保险
钢院	钢铁学院
航联	航空联合会
俄队	俄国家队
损减	损失减少
公厕	公共厕所
批建	批准建设
湿控	湿度控制
地学	地球科学
上昆	上海昆剧团
劳联	劳工联合会
毛著	毛泽东著作
军需所	军需装备研究所
刑庭	刑事法庭
断交	断绝外交关系
尤杯赛	尤伯杯赛
女超	女子超级
南华会	香港南华体育会
地球所	地球物理研究所
私财	私人财产
亚网联	亚洲网球联合会
磨耗	磨损消耗
棉站	棉花收购站
共享税	中央和地方共享税
蔬果	蔬菜水果
巴航	巴基斯坦航空公司
长委	长江水利委员会
普工	普通工人
苏杭	苏州和杭州
新地	新鸿基地产
港监	港务监督
高教委	高等教育委员会
空距	空中距离
裁委会	裁判委员会
植棉	种植棉花
拳协	拳击协会
临委会	临时委员会
农军	农民自卫军
地矿	地质矿产
帮贫	帮助贫困户
复关	恢复关贸总协定缔约国地位
掌珠	掌上明珠
博导	博士生导师
余资	剩余资金
机器人所	机器人研究所
英航	英国航空公司
护产	保护财产
国际棋联	国际象棋联合会
农用电	农业用电
人武	人民武装
一秘	一等秘书
宣教	宣传教育
欧空局	欧洲空间局
内资	国内资本
近物所	近代物理研究所
施袭	实施袭击
续演	继续演出
护校	护士学校
教卫	教育和卫生
中野	中原野战军
植物所	植物研究所
文卫体	文化卫生体育
巴盟	内蒙古自治区巴彦淖尔盟
刑辩	刑事辩护
电感	电子感应
西语	西班牙语
县干	县级干部
联试	联合试验
冶金所	冶金研究所
自控力	自我控制力
清财	清理财产
炮指	炮兵指挥部
妇救会	妇女救国会
损农	损害农民利益
节汇	节约外汇
主因	主要原因
计财处	计划财务处
彩卷	彩色胶卷
环情	环境情况
师友	老师和朋友
公捕	公开逮捕
共保	共同保护
外需	外部需求
临快	临时快车
金属所	金属研究所
苏绣	苏州刺绣
书艺	书法艺术
世经所	世界经济研究所
城郊	城市郊区
七纵	第七纵队
公平会	公平交易委员会
电子科大	电子科技大学
台客	台湾旅客
建工	建筑工程
上交会	上海商品交易会
深大	深圳大学
全教会	全国教育工作会议
伊阵	伊斯兰拯救阵线
耶教	耶稣教
招干	招聘干部
马盟	阿拉伯马格里布联盟
督查	监督检查
体院	体育学院
女垒	女子垒球
反战	反对战争
增招	增加招生
研发	研究开发
国企	国有企业
杭州艺专	杭州艺术专科学校
征期	征收期
盲协	盲人协会
海委会	政府间海洋学委员会
尸解	尸体解剖
声画	声音和画面
海院	航海学院
拉美	拉丁美洲
篮赛	篮球赛
要角	重要角色
空压机	空气压缩机
亚田联	亚洲田径联合会
劳服	劳动服务
劳大	全国劳动大会
主险	主要保险
人教社	人民教育出版社
党建	党的建设
助研	助理研究员
个唱	个人演唱会
人口普查办	人口普查领导小组办公室
香港工联	香港工会联合会
教院	教育学院
艺院	艺术学院
化武	化学武器
安委办	安全生产委员会办公室
国际垒联	国际垒球联合会
古丝路	古代丝绸之路
全委	全国委员会
流资	流动资金
五城会	第五届城市运动会
足协	足球协会
科考	科学考察
女曲	女子曲棍球队
政圈	政治圈子
补税	补交税款
棉织	棉纺织
舰院	舰艇学院
春招	春季招生
手拖	手扶拖拉机
朝军	朝鲜军队
劳教	劳动教养
职高	职业高中
农本	农业成本
观赛	观看比赛
电算	电子计算
欧行	欧洲之行
春考	春季考试
修律	修订法律
剑校	击剑学校
上芭	上海芭蕾舞团
八办	八路军办事处
股价	股票价格
汤杯	汤姆斯杯
民庭	民事法庭
小巴	小型巴士
下议员	下议院议员
初教	初等教育
体工	体育工作
修宪	修改宪法
经研	经济研究
空地导弹	空对地导弹
田管	田间管理
旅展	旅游展览
守疆	守卫边疆
软交会	软件交易会
教文	教育和文化
五四三	五讲四美三热爱
建外	建国门外
组工	组织工作
刑释人员	刑满释放人员
上航	上海航空公司
老协	老年人协会
泳技	游泳技术
机械委	机械工业委员会
统招	统一招生
重教	重视教育
农中	农业中学
西画	西洋画
少足	少年足球
财相	财政相
食监	食品卫生监督检验
纳指	纳斯达克综合指数
群管	群众管理
公铁	公路铁路
交行	交通银行
联保	联合保险
治贪	惩治贪污
拒付	拒绝支付
网膜	视网膜
公判	公开宣判
评职	评定职称
边检	边防检查
控污	控制污染
市宫	市工人文化宫
拘审	拘留审查
马列主义	马克思列宁主义
保教	保育教育
四机部	第四机械工业部
政指	政治指导员
收证	收集证据
街总	街坊总会
艺大	艺术大学
水保	水土保持
西农大	西北农业大学
盲校	盲人学校
地价	土地价格
红中社	红色中华通讯社
批捕	批准逮捕
经合	经济合作
六机部	第六机械工业部
轻汽	轻型汽车
抗改	抗拒改造
修院	修道院
开发署	联合国开发计划署
安控	安全控制
尿检	尿样检查
军妓	随军妓女
艺创	艺术创作
时事社	时事通讯社
语言所	语言研究所
摩协	摩托车协会
影星	电影明星
一幼	第一幼儿园
中委	中央委员
桥联	桥牌联合会
文摘	文章摘要
妇代会	妇女代表大会
摄协	摄影家协会
县府	县人民政府
女团	女子团体
铁三院	铁道部第三勘测设计院
天影厂	天津电影制片厂
汽贸	汽车贸易公司
云大	云南大学
票选	投票选举
私企	私营企业
青干班	青年干部培训班
前委会	前敌委员会
瓶啤	瓶装啤酒
刑警局	刑事警察局
增销	增加销售
智能所	智能研究所
运贸	运输贸易
国际计生联	国际计划生育联合会
维港	维多利亚港
标售	标价出售
莫大	莫斯科大学
哈医大	哈尔滨医科大学
安保员	安全保卫人员
曲作家	词曲作家
工展会	工业展览会
苦研	刻苦钻研
餐营	餐车经营
餐旅	餐饮旅游
共治	共同治理
治则	治疗原则
居委会	居民委员会
语工	语言文字工作
核研所	核能研究所
台湾两岸	台湾海峡两岸
国标	国家标准
消总	消防总队
彩报	彩色报纸
突审	突击审讯
税制	税收制度
控区	控制区
家计会	香港家庭计划指导会
海校	海军学校
特需	特殊需要
农科	农业科学
水电大	水利电力大学
营收	营业收入
官校	军官学校
大龄	大年龄
商标权	商标专用权
国际网联	国际网球联合会
外销	对外销售
港人	香港人
电建	电力建设
体健	身体健康
美航	泛美航空公司
强迁	强制迁移
残部	残余部队
舞师	舞蹈教师
煤管局	煤炭管理局
电修	电机修理
参游	参加旅游
武大	武汉大学
自贸区	自由贸易区
路警	铁路警察
城管	城市管理
女台	女子跳台跳水
早教	早期教育
欧市	欧洲市场
质标	质量标准
招教	招聘教师
从商	从事商业
节市	节日市场
社党	社会民主党
天民党	天主教民主党
金价	黄金价格
纠风	纠正行业不正之风
校运会	学校运动会
广电部	广播电影电视部
岗培	岗位培训
拒批	拒绝批准
建安公司	建筑安装公司
计陷	设计陷害
自协	自行车运动协会
赤几	赤道几内亚
首演	首场演出
司助	司法救助
杞忧	杞人之忧
残奥运	残疾人奥林匹克运动
影业	电影业
特教班	特殊教育班
吉大	吉林大学
书赛	书法比赛
鲁艺	鲁迅艺术文学院
扩灌	扩大灌溉面积
婉拒	婉言拒绝
商检	商品检验
女校	女子学校
判监	判处监禁
校委会	校务委员会
民促	民主促进会
财年	财政年度
土军	土耳其军队
统检	统一检查
国际冰联	国际冰球联合会
握别	握手告别
昆腔	昆山腔
汽运公司	汽车运输公司
杜诗	杜甫的诗
体协	体育协会
药物所	药物研究所
西北师大	西北师范大学
经联社	经济联合社
台企	台湾企业
农技	农业技术
去今	去年今年
商台	商业电台
热工	热能工程
森工	森林工业
社教	社会教育
邮协	集邮协会
下权	下放权力
调解会	人民调解委员会
创议	创新建议
首图	首都图书馆
扩校	扩大学校
公关	公共关系
国家民委	国家民族事务委员会
话机	电话机
陆航	陆军航空兵
金市	黄金市场
世界工联	世界工会联合会
师院	师范学院
全国青联	中华全国青年联合会
教德	教师职业道德
三产	第三产业
航母	航空母舰
建协	建筑协会
人道立场	人道主义立场
奥体	奥林匹克体育
长二丙	长征二号丙
俄航	俄罗斯航空公司
农话	农村电话
家服	家庭服务
联委会	联合委员会
森警	森林警察
投建	投资建设
中院	中级人民法院
港片	香港影片
国列	国际旅客列车
上戏	上海戏剧学院
二秘	二等秘书
北影	北京电影制片厂
外军	外国军队
纯善	纯朴善良
经货联盟	欧洲经济货币联盟
日航	日本航空公司
税检	税收检查
杭大	杭州大学
参访	参观访问
行管	行政管理
群工	群众工作
义消	义务消防队
护鸟	保护鸟类
日用品	日常生活用品
美校	美术学校
落政	落实知识分子政策
空港	航空港
股值	股票价值
尤杯	尤伯杯
植保	植物保护
共管	共同管理
外秘	外交秘书
垒协	垒球协会
林科所	林业科学研究所
管养	管理和养护
外院	外国语学院
空战	空中作战
软件所	软件研究所
二医大	上海第二医科大学
人普	人口普查
个税	个人所得税
职校	职业学校
坚拒	坚持拒绝
公投	公民投票
牡丹卡	牡丹信用卡
严管	严格管理
医技	医疗技术
息率	利息率
军贸	军火贸易
邮市	邮票市场
林研所	林业研究所
职改	职称改革
棒协	棒球协会
舞协	舞蹈家协会
监销	监督销毁
粮经	粮食经济
上音	上海音乐学院
亚冬会	亚洲冬季运动会
艺展	艺术展览
减资	减少资本
减亏	减少亏损
外联部	对外联络部
墨通社	墨西哥通讯社
代总长	代理总参谋长
医助	医生助理
国补	国家补贴
高能所	高能物理研究所
南艺	南京艺术学院
金杯公司	金杯通用汽车有限公司
社青	社会青年
高院	高级人民法院
军婚	军人婚姻
澳督府	澳门总督府
政改	政治体制改革
台生	台湾学生
非统	非洲统一组织
粮改	粮食购销体制改革
济铁	济南铁路局
女监	女子监狱
体彩	体育彩票
沙俄	沙皇俄国
国际赛联	国际赛艇联合会
裂伤	撕裂伤
工纠	工人纠察
管委	管理委员会
涉老	涉及老年人
申装	申请安装
显外	显微外科
青妇	青年妇女
农投	农业投资
塑编	塑料编织
西安体院	西安体育学院
例验	例行检验
打防	打击和防范
停捕	停止捕捞
绥署	绥靖公署
计量局	标准计量局
粪管	粪便管理
韩商	韩国商人
国控	国家控制
花市	花卉市场
速滑	速度滑冰
和约	和平条约
抬价	抬高价格
卫片	卫星照片
企银	企业银行
盟体	联盟体
商贷	商业贷款
跌势	下跌趋势
医委会	医学委员会
东航	东方航空公司
一战后	第一次世界大战后
驾机	驾驶飞机
应化	应用化学
规土局	规划土地局
参会	参加会议
血防	血吸虫病防治
二炼钢	第二炼钢厂
新协	新闻工作者协会
市队	市代表队
销文	销毁文件
农合工	农民合同制工人
制程	制造过程
领馆	领事馆
评模	评选模范
局地	局部地区
一冶	第一冶炼厂
治整	治理和整顿
罪因	犯罪原因
村委	村民委员会
学运	学生运动
陶研	陶行知研究
海科	海洋科学
港府	香港政府
市商委	市商业委员会
人医	人民医院
建陶	建筑陶瓷
运管	运输管理
音协	音乐家协会
电大	广播电视大学
上铁	上海铁路局
困斗	困兽犹斗
地科院	地质科学研究院
加航	加拿大航空公司
统算	统一核算
泳协	游泳协会
党工	党务工作
残协	残疾人体育协会
西工大	西北工业大学
万国邮联	万国邮政联盟
禁产	禁止生产
民爆器材	民用爆破器材
燕大	燕京大学
欧华联会	欧洲华侨华人社团联合会
岸炮	海岸炮
教办	教育办公室
安医大	安徽医科大学
师大	师范大学
日银	日本银行
受托	接受委托
浙昆	浙江昆剧团
密报	秘密报告
楼按	楼宇按揭
期市	期货市场
收审	收容审查
铁十六局	铁道部第十六工程局
影赛	摄影比赛
整纪	整顿纪律
外空	外层空间
城雕	城市雕塑
企协	企业家协会
职评	职称评定
社群	社会群体
阿盟	阿拉伯国家联盟
禁登	禁止刊登
墨市	墨西哥市
红属	红军家属
军转干	军队转业干部
现况	现实情况
证交所	证券交易所
妇女会	妇女协会
台市	台湾股市
临管	临时管理
水运	水路运输
亚俱杯	亚洲俱乐部杯
虫草	冬虫夏草
艺文	艺术文化
袭警	袭击警察
港姐	香港小姐
行止	行为举止
劳卫	劳动卫生
十五中	第十五中学
销势	销售形势
犯属	犯人家属
清档	清理档案
育乐	体育娱乐
丝路	丝绸之路
铁二院	铁道部第二勘测设计院
电院	电子工程学院
农发基金会	国际农业发展基金会
助审员	助理审判员
上远公司	上海远洋运输公司
交咨会	交通咨询委员会
商服	商业服务业
企办	企业办公室
经建	经济建设
直客	直通旅客列车
航院	航空学院
非公经济	非公有经济
地埋	地下埋藏
特委	特别委员会
劳技	劳动和技术
生物所	生物研究所
南大	南京大学
泌乳	分泌乳汁
煤化所	煤炭化学研究所
油建	油田建设
警署	警察署
尼大	尼赫鲁大学
标煤	标准煤
市交委	市交通委员会
技校	技工学校
中戏	中央戏剧学院
省医	省立医院
原子能所	原子能研究所
一机厂	第一机械厂
炮团	炮兵团
亚姐	亚洲小姐
亚洲手联	亚洲手球联合会
国统区	国民党统治区
月入	每月收入
演词	演说词
公用局	公用事业局
大体协	大学生体育协会
美工	美术工作
教统会	香港教育统筹委员会
调温	调节温度
农广	农业广播
古史	古代历史
厂校	工厂和学校
拳赛	拳击比赛
主研人	主要研究人
针麻	针刺麻醉
禁映	禁止放映
财经委	财政经济委员会
基建	基本建设
刑释	刑满释放
汉译	汉语翻译
文娱	文化娱乐
菲央行	菲律宾中央银行
侦处	侦查处理
增速	增长速度
平摊	平均分摊
延安鲁艺	延安鲁迅艺术学院
联贷	联合贷款
关检	海关检查
农发基金	农村发展基金
北师院	北京师范学院
民宗委	民族宗教委员会
干教	干部教育
脑体	脑力劳动和体力劳动
外烟	外国香烟
川航	四川航空公司
建管	建筑管理
基材	基本材料
商经	商业经济
国家商检局	国家进出口商品检验局
证管办	证券管理办公室
呼市	呼和浩特市
俄商	俄罗斯商人
彩影	彩色摄影
临建	临时建筑
批价	批发价格
文改	文字改革
助编	助理编辑
专责	专门负责
个体户	个体工商户
饮服	饮食服务
劳改	劳动改造
电教	电化教学
国际马联	国际马术联合会
安保	安全保卫
陕公	陕北公学
步炮	步兵和炮兵
外贸部	对外贸易部
酒钢	酒泉钢铁公司
参训	参加训练
过境税	过境关税
统分	统一分配
瓦检员	瓦斯检测员
学工部	学生工作部
武联	武术联合会
高护	高级护士
外贸	对外贸易
日贷	日本贷款
观展	参观展览
军基	军事基地
中总	香港中华总商会
国家计生委	国家计划生育委员会
长服	长期服用
亚青	亚洲青年
佳市	佳木斯市
举发	检举揭发
管护	管理和保护
世卫组织	世界卫生组织
职大	职工大学
高工	高级工程师
玻纤	玻璃纤维
保共	保加利亚共产党
完封	完全封锁
扩红	扩大红军
平叛	平息叛乱
美编	美术编辑
直机关	直属机关
欧航局	欧洲航天局
刑拘	刑事拘留
男网	男子网球
搜证	搜集证据
兑汇	兑换外汇
医协	医学协会
支现	支取现金
联储局	联邦储备局
黄委会	黄河水利委员会
车况	车辆状况
心搏	心脏搏动
控亏	控制亏损
实效	实际效果
大众传媒	大众传播媒介
赛题	竞赛题目
信资	信托投资
特批	特别批准
华师大	华东师范大学
旅专	旅游专科学校
律协	律师协会
林机厂	林业机械厂
幼托	幼儿入托
经院	经济学院
工疗	工人疗养院
全麻	全身麻醉
收教	收容教育
民初	民国初年
影技	摄影技术
联招	联合招生
教科所	教育科学研究所
作训	作战训练
访查	访问调查
学联	学生联合会
切宫	切除子宫
短训班	短期培训班
精研	精心研究
债信	债务信用
花博会	花卉博览会
军报	解放军报
篮总	香港篮球总会
组设	组织设立
高检	最高人民检察院
业委会	业主委员会
津百	天津百货
委办	委员会办公室
海俱	海员俱乐部
政训	政治训练
人美	人民美术出版社
联航	联合航空公司
友协	友好协会
要项	重要项目
街办	街道办事处
武星	武打明星
船舶证书	船舶检验证书
彩超	彩色B超
工属	职工家属
全代会	全国代表大会
北体	北京体育大学
控会	控制会议
心梗	心肌梗塞
一炼钢	第一炼钢厂
文管办	文化市场管理办公室
北京人艺	北京人民艺术剧院
中评委	国民党中央评议委员
街委	街道委员会
院党办	院党委办公室
违宪	违反宪法
建机厂	建筑机械厂
师专	师范专科学校
治污	治理污染
视协	电视艺术家协会
速算	快速计算
广府	广州政府
吉化	吉林化学工业公司
助查	协助调查
庭期	开庭日期
财金	财政金融
派红	派发红利
日俘	日本战俘
掌理	掌握管理
普获	普遍获得
货检	货物检验
胸透	胸部透视
招选	招聘选拔
辽沈	辽宁沈阳
企务	企业事务
中东和谈	中东和平谈判
海缆	海底电缆
舞星	舞蹈明星
劳保	劳动保护
二汽	第二汽车制造厂
聚赌	聚众赌博
家教	家庭教育
巴黎公约	保护工业产权巴黎公约
人劳局	人事劳动局
定存	定期存款
研审	研究审查
统测	统一测试
粮援	粮食援助
赛地	比赛地点
商展	商品展览
史展	历史展览
干管	干线管道
地导弹	地对地导弹
外次	外交部次官
税干	税务干部
方尺	平方英尺
函大	函授大学
煤质	煤炭质量
统管	统一管理
女柔	女子柔道
普种	普遍接种
图博	图书馆和博物馆
侦技	侦察技术
防台	防御台风
审执	审理执行
影圈	电影圈
农险	农业保险
联共	联合共产党
电业	电力工业
哈军工	哈尔滨军事工程学院
浙大	浙江大学
上师大	上海师范大学
长城卡	长城信用卡
遗传所	遗传研究所
叙军	叙利亚军队
幼专	幼儿师范专科学校
商流	商品流通
四城会	第四届城市运动会
公校	公办学校
订颁	制订并颁布
国税局	国家税务局
油国	石油出口国
食市	食品市场
高师	高等师范
哥大	哥伦比亚大学
化废	化学废物
首拍	首次拍卖
肌注	肌肉注射
城工	城市工作
评优	评选优秀
少体	少年体育
军停会	朝鲜军事停战委员会
专署	专员公署
工效	工作效率
烈属	烈士家属
金贸	黄金贸易
反殖	反对殖民主义
津城	天津城
显效	显著效果
生资	生产资料
罗政	罗马尼亚政府
工调	工资调整
私小	私立小学
法工委	法制工作委员会
港澳办	港澳事务办公室
强震	强烈地震
痕检	痕迹检验
和谈	和平谈判
农信联社	农村信用联社
聋校	聋哑学校
探空	探测太空
菊展	菊花展览
实操	实际操作
上京	上海京剧院
工时	工作时间
引资	引进资金
清大	台湾清华大学
访演	访问演出
煤炭部	煤炭工业部
辽大	辽宁大学
实控线	实际控制线
中大	中山大学
深交所	深圳证券交易所
储种	储蓄种类
文工会	文化工作委员会
国银	国际清算银行
男乒	男子乒乓球
众院	众议院
直资	直接资助
运距	运输距离
七机部	第七机械工业部
动物所	动物研究所
摩联	摩托车联合会
基训	基本训练
城调队	城市调查队
参演	参加演出
飞行队	飞行服务队
中财委	中央财政经济委员会
温控	温度控制
