大运	大学生运动会
民乐团	民族音乐团
林化所	林业化学研究所
女网	女子网球
计控	计量控制
消联	消费者联合会
中心馆	中心图书馆
文体科	文艺体育科
大专	大学专科
铁委	铁路委员会
行政庭	行政审判庭
预赤	预算赤字
手工	手工业
外宾	外国来宾
民政办	民政办公室
商住小区	商业住宅小区
工业所	工业经济研究所
幼师	幼稚园教师
建照	建筑执照
经联会	经济联合会
铁总	铁路总工会
技改费	技术改造费
职灾	职业灾害
环幕	环形银幕
军情	军事情报
陶艺	陶瓷艺术
经济庭	经济审判庭
建材	建筑材料
世界拳协	世界拳击协会
总裁办	总裁办公室
军警宪特	军队警察宪兵特务
美协	美术家协会
旅团	旅行团
国际学联	国际学生联合会
谍参队	军事谍报参谋队
面值	票面价值
劳协	劳动者协会
兵总	兵器工业总公司
全国人大	全国人民代表大会
舞研所	舞蹈研究所
企管站	企业管理站
保健医	保健医生
中央工艺美院	中央工艺美术学院
财税局	财政税务局
外资办	外资办公室
政院	政治学院
海洋所	海洋研究所
影本	电影剧本
私房	私人住房
时流	时代潮流
冶金部	冶金工业部
植化	植物化学
省人大	省人民代表大会
世界针联	世界针灸联合会
工总	工业总会
球阀	球形阀
少先队	少年先锋队
外商	外国商人
绍酒	绍兴酒
经技开发区	经济技术开发区
精仪	精密仪器
口岸办	口岸办公室
计办	计划办公室
核试	核试验
青联节	青年联欢节
保健办	保健办公室
边检站	边防检查站
技改	技术改造
电离计	电离真空计
地富反坏	地主富农反革命分子坏分子
邮工	邮政工会
艺协	艺术家协会
农林牧	农业林业牧业
地热电站	地球热能发电站
政府办	政府办公室
静点	静脉点滴
男单	男子单打
钻饰	钻石首饰饰品
国际柔联	国际柔道联合会
个贷	个人贷款
标样	标准样品
敌档	敌方档案
委主任	居民委员会主任
工经	工业经济
全委会	全体委员会议
水旱	水田旱地
彩色管	彩色显像管
棉办	棉花办公室
硕导	硕士生导师
船管站	船只管理站
交安员	交通安全员
车管	车辆管理
陆积	陆地面积
民艺品	民间艺术品
天地生	天文地理生物
商住楼	商业住宅楼房
文体	文娱体育
职总	职工总会
工美	工艺美术品
人大办	人大办公室
农办	农业办公室
工代会	工人代表大会
行纪	行业纪律
粮校	粮食学校
城运	城市运动会
职校	职业学校
德行	品德行为
剧评	戏剧评论
艺研所	艺术研究所
班务	班级事务
人委	人民委员会
社劳党	社会主义劳动党
信用社	信用合作社
世拳理	世界拳击理事会
手绣	手工刺绣
学代会	学生代表大会
光机所	光学精密机械研究所
网联	网球联合会
核物理	原子核物理学
文秘	文书秘书
文博	文物博物
医械	医疗器械
工业废物	工业固体废物
农大	农业大学
公汽公司	公共汽车公司
武委	武术委员会
中小教联	中学小学教师联合会
菜办	蔬菜办公室
青工部	青年工作部
男警	男性警察
政协办	政协办公室
戏协	戏剧家协会
世象联	世界象棋联合会
自民党	自由民主党
拳总	拳击总会
体疗	体育医疗
地研所	地质研究所
汽修厂	汽车修理厂
工副	工业副业
妇委会	妇女委员会
机院	机械学院
能办	能源办公室
妇幼站	妇女幼儿保健站
世青赛	世界青年锦标赛
华资	华人资金
农职校	农村职业学校
塑化	塑料化工
纺机	纺织机械
曲韵	戏曲音韵
外汇局	外汇管理局
煤机厂	煤矿机械厂
国际桥联	国际桥牌联合会
文艺	文化艺术
政法委	政法委员会
军大	军政大学
茶料	茶叶作料
冰联	冰球联合会
技干	技术干部
报摘	报纸文摘
光缆	光纤通讯电缆
机电部	机械电子工业部
交运	交通运输
技委会	技术委员会
城管委会	城市管理委员会
文代会	文学艺术工作者代表大会
地卫站	地面卫星接收站
固体火箭	固体推进剂火箭
背姿	背部姿势
个调税	个人收入调节税
化医	化学医学
央航	中央航空公司
广电部	广播电视部
市政委	市政工程委员会
财院	财经学院
植物生理所	植物生理研究所
干属	干部家属
刑诉法	刑事诉讼法
党训班	党员培训班
婴幼	婴儿幼儿
图品	图书制品
客货	旅客货物
家财	家庭财产
艺档	艺术档案
院规	学院规章
白权	白人特权
主计	主任会计
规条	规定条款
舞美	舞台美术
软饮	软饮料
煤科	煤炭科学
财税系统	财政税务系统
全锦赛	全国锦标赛
农医	农村医疗
心防	心理防线
制博会	装备制造业博览会
职级	职务级别
教参	教学参考资料
亲邻	亲朋邻居
女干	妇女干部
中芭	中央芭蕾舞团
团寿险	团体人寿保险
行包	行李包裹
科情所	科学情报研究所
盲杖	盲人手杖
保险额	保险金额
武警	武装警察
侨商	华侨商业银行
德智体美	德育智育体育美育
双拥办	双拥办公室
助教	助理教师
体表	身体表面
地质所	地质研究所
农科站	农业科技站
农机局	农业机械局
总体设计	总体规划设计
电表	电测量指示仪表
青科协	青年科技工作者协会
戏文系	戏剧文学系
外侨	外籍侨民
内政办	内政办公室
农研室	农村政策研究室
户政科	户籍政策科
印厂	印刷厂
邮管局	邮电管理局
评文	评论文章
管输	管道输送
机校	机械学校
劳模	劳动模范
军力	军事力量
羽交会	羽绒制品交易会
路桥隧	公路桥梁隧道
海陆空	海港陆路航空
仓管员	仓库管理员
幼托	幼儿园托儿所
硬卧	硬席卧铺
大篮协	大学生篮球协会
科技社	科学技术出版社
义警	义务警察
煤检费	煤炭检查费
病患者	病人患者
青协	青年协会
大学生体联	大学生体育联合会
木机厂	木工机械厂
农展	农业展览会
保联	保龄球联合会
参院	参议院
脊灰	脊髓灰质炎
排协	排球协会
司政后	司令部政治部后勤部
文理	文科理科
仓容	仓库容量
费负	费用负担
团支部	共青团支部
中小幼	中学小学幼儿园
隧巴	隧道巴士
职大	职工大学
网协	网球协会
农电网	农村电网
消协	消费者协会
武总招	武警总队招待所
名词委	名词委员会
直流	直流电
纺院	纺织工业学院
机译	机器翻译
轻机所	轻工业机械研究所
商事	商业事务
公意	公民意愿
民研所	民族研究所
农负	农民负担
科考队	科学考察队
军机	军事机密
心外科	心血管外科
护龄	护士工龄
矿管局	矿产资源管理局
军干	军队干部
警校	警察学校
玻纤院	玻璃纤维研究院
外航	外国航空公司
世运会	世界运动会
党支书	党支部书记
关员	海关人员
农影	农业电影制片厂
女乒	女子乒乓球队
国烟局	国家烟草专卖局
勋业	功勋事业
果菜业	水果蔬菜行业
片源	影片来源
残联	残疾人联合会
政法大	政法大学
少队部	少年先锋队队部
民兵运动会	民兵军事体育运动会
政经	政治经济学
农水	农田水利
工展馆	工业展览馆
昆虫所	昆虫研究所
话剧所	话剧研究所
花纱布	棉花棉纱棉布
童军	童子军
校警	学校警卫
乞服	乞丐服装
校董会	学校董事会
食协	食品工业协会
纺校	纺织工业学校
公汽	公共汽车
陶建	陶瓷建筑材料
企标	企业标准
治绩	政治业绩
编程	编制程序
中央美院	中央美术学院
芭团	芭蕾舞团
总长	总参谋长
吧女	酒吧女郎
联汇制	联系汇率制度
矿机厂	矿山机器厂
经参处	经济参赞处
管输费	管道输送费
人媒	人体媒介
艺师	艺术师范学校
国际曲棍联	国际曲棍球联合会
学额	学生名额
节庆	节日庆典
粮价	粮食价格
密语	密码语言
球圈	球类运动员圈子
牌费	车牌费用
工产	工业生产
电工部	电力工业部
科幻	科学幻想
顾委	顾问委员会
校护	学校护士
行址	银行地址
空冷器	空气冷却器
标粉	标准面粉
摩阻力	摩擦阻力
党政警民	党组织政府部门警察民众团体
特府	特区政府
粮管所	粮食管理所
世协	世界语协会
演职	演员职员
首体	首都体育馆
路局	铁路局
音效	音响效果
交委	交通委员会
共青团	共产主义青年团
计控室	计算机控制室
城调局	城市调查局
激唱	激光唱机
交大	交通大学
农职中	农村职业中学
外策	外交政策
农体协	农民体育运动协会
电工局	电器工业管理局
专办	专案办公室
科办	科技办公室
邮联	邮政联盟
世界羽联	世界羽毛球联合会
安居办	安居工程办公室
影视所	电影电视研究所
土杂公司	土产日用品杂品公司
乘委会	乘客委员会
国际体育记联	国际体育记者联合会
牢监	牢房监狱
电讯	电子通讯
住房办	住房办公室
包商	承包商
电子办	电子工业办公室
调焦	调整焦距
剧毒品	剧毒性商品
口讯	口语资讯
海装部	海军装备技术部
曲联	曲棍球联合会
声学所	声学研究所
友赛	友谊赛
科协	科学技术协会
面的	面包车型的士
党代会	党代表大会
营建	营房建筑
社保费	社会保险费
信贷款	信用贷款
国际排联	国际排球联合会
架构	框架结构
法制办	法制办公室
棉贷	棉花贷款
等离子体所	等离子体研究所
职技	职业技术
企业委	企业委员会
报警	报告警方
时政	时事政治
科技	科学技术
残运	残疾人运动会
体事	体育赛事
地税局	地方税务局
银系	银河系
商交所	商品交易所
消委会	消费者委员会
家床科	家庭病床科
轻工厅	轻工业厅
羽协	羽毛球协会
国姐	国家小姐
世拳协	世界拳击协会
农机办	农业机械办公室
壁饰	墙壁装饰
广协	广告协会
女师	女子师范学校
运程	命运进程
交通量	交通流量
狱务	监狱事务
老幼	老年人幼儿
世青	世界青年
全员	全体成员
驼绒	骆驼绒
油市	石油市场
航模	航空模型
中教	中学教师
军统	军统局
僚气	官僚习气
文体用品	文教体育用品
降本	降低成本
微生物所	微生物研究所
民负	人民负担
街委会	街道居民委员会
作协	作家协会
社经	社会经济
商界	商业界
舞校	舞蹈学校
干训班	干部培训班
语料	语言材料
消保法	消费者保护法
汽修业	汽车修理业
首汽	首都汽车公司
文哲所	文学哲学研究所
民乐	民族音乐
动因	动机原因
职中	职业中学
男双	男子双打
空陆海	空军陆军海军
博协	博物馆协会
球卡	球员卡
经委办	经济委员会办公室
转速表	转速测量仪表
坝电	大坝发电厂
童装	儿童服装
社盟	社会联盟
工大	工业大学
演训班	演员培训班
环保科研所	环境保护科学研究所
艺小	艺术小学
现局	现实局势
区委办	区委办公室
纺企	纺织企业
文工团	文艺工作团
资委会	国民党政府资源委员会
农技员	农业技术人员
摄录设备	摄像机录像机设备
大体联	大学生体育联合会
国际足联	国际足球联合会
泪弹	催泪弹
世锦赛	世界锦标赛
市管费	市场管理费
国府	国民政府
声像	声音图像
农资	农业生产资料
少管所	少年管教所
城巴	城市巴士
邮码	邮政编码
林科院	林业科学院
编务	编辑业务
现值	现实价值
搪协	搪瓷协会
干群	干部群众
乒协	乒乓球协会
中运会	中学生运动会
职高生	职业高中学生
食杂店	食品杂货店
农险处	农业保险处
农牧林	农业牧业林业
画艺	绘画艺术
公交	公共交通
老体协	老年人体育协会
首师大	首都师范大学
低幼	低龄幼儿
经委	经济委员会
儿艺	儿童艺术
军检	军事检察院
物构所	物质结构研究所
国际乒联	国际乒乓球联合会
民运会	少数民族运动会
纪委会	纪律委员会
助师	助理工程师
警总	警备总部
牧副渔	牧业副业渔业
党政军群	党组织政府部门军队群众
美编室	美术编辑室
党工妇青	党委会工会妇女联合会青年团
军体	军事体育
院务会	学院事务会议
智残	智力残疾
林大	林业大学
车市	汽车市场
图洽会	图书洽谈会
教代会	教师代表大会
商誉	商业信誉
报业	报纸出版业
大本	大学本科
外委会	外交委员会
国家体委	国家体育运动委员会
荣军	荣誉军人
党政军民学	党组织政府部门军队民众团体学生
贫协	贫农协会
市百货	市百货公司
基干	基层骨干
外空法学	外层空间法学
化机厂	化工机械厂
森工局	森林工业局
社保处	社会保险费事业处
体师	体育师范学校
女手	女子手球
医界	医疗界
梅鹿	梅花鹿
空姐	空中小姐
专才	专业人才
股份公司	股份制有限公司
火电站	火力发电站
军科院	军事科学院
车险公司	汽车保险公司
排联	排球联合会
农化品	农业化学品
荣军院	荣誉军人休养院
马列文论	马克思列宁主义文艺理论
农械	农业机械
共盟	共产主义者联盟
农贷	农业贷款
半导体所	半导体研究所
商机	商业机械
控温	控制温度
中常会	国民党中央常委会
园管局	园林管理局
文档	文书档案
财纪	财经纪律
基盘	基础地盘
科工协会	科学工作者协会
乒总	乒乓球总会
医具	医疗器具
核武库	核武器库
电站	发电站
党政群	党组织政府部门群众
国际铁协	国际铁路协会
集企	集体企业
电话办	电话办公室
特区	经济特区
胆石	胆囊结石
省话	省话剧团
书家	书法家
黄带	黄色录像带
纺工部	纺织工业部
大运村	大学生运动员村
粮企	粮食企业
金银	金牌银牌
青训班	青年培训班
女篮	女子篮球队
楼股	楼房股票
植生所	植物生理所
农轻重	农业轻工业重工业
农机	农业机械
供校	供销商业学校
核武	核武器
渔技	渔业技术
市办	市委办公室
扩频通信	扩展频谱通信
青运会	青年体育运动会
市务	市场业务
家装	家居装饰
世青足球赛	世界青年足球锦标赛
粮机厂	粮食机械厂
外佣	外籍女佣
商粮	商品粮
公疗	公费医疗
机动科	机械动力科
外教	外籍教师
戏曲所	戏曲研究所
地院	地质学院
战罪	战争罪行
特区办	特区办公室
拒收	拒绝接收
药化	药物化学
房津	房屋津贴
国际社	国际社会服务社
婚介所	婚姻介绍所
律管处	律师管理处
词作	词作者
电化铁路	电气化铁路
车模	汽车模型
工农比价	工农业商品交换比价
牛丸	牛肉丸子
妇教所	妇女教养所
副贴	副食品价格补贴
期金	期货资金
国际手联	国际手球联合会
文管所	文化管理所
足校	足球学校
速冻	快速冷冻
海协	大陆海峡两岸关系协会
技交会	技术交易会
文联	文学艺术家联合会
机位	飞机位置
网羽	网球羽毛球
业界	产业界
市总	市总工会
青话	青年话剧团
行管局	行政管理局
公退金	公务员退休金
税负	税务负担
村助	村长助理
民院	民族学院
大运会	大学生运动会
全纺会	全国纺织品交易会
翠戒	翡翠戒指
农管局	农业管理局
艺委会	艺术委员会
企管处	企业管理处
尸表	尸体表面
心内科	心血管内科
经管站	经济管理站
女装	女子服装
国防委	国防委员会
幼园	幼儿园
政文	政治文艺
文管局	文化管理局
国基	国家基础
校办	校长办公室
妇委	妇女委员
区政	区政府
电研所	电子研究所
市人大	市人民代表大会
书协	书法家协会
物交会	物资交易会
展馆	展览馆
敌工部	敌区工作部
外片	外国影片
敌特	敌方特务
炮研所	炮兵防空兵装备技术研究所
保额	保险金额
政团	政治团体
材质	材料质量
编办	编辑部办公室
峰会	高峰会议
技联	技巧联合会
空司	空军司令部
集贸	集市贸易
银企	银行企业
群体	群众体育
科仪	科学仪器
支哮	支气管哮喘病
土特	土产特产
战债	战争债务
独联体	独立国家联合体
税警局	税务警察局
摩配	摩托车配件
能委	能源委员会
篮协	篮球协会
生源	学生来源
乡干	乡干部
工研院	工业研究院
白喉杆菌	白喉棒状杆菌
嫌犯	嫌疑犯
团训班	团干部训练班
生化	生物化学
矿大	矿业大学
真相委	真相委员会
电教室	电化教学室
音院	音乐学院
海燕厂	海燕电影制片厂
群文	群众文化艺术
房管局	房产地产管理局
港务局	港务管理局
财赤	财政赤字
电子局	电子工业局
军工局	军事工业局
样车	样本列车
人艺	人民艺术剧院
市政办	市政工程办公室
光纤	光导纤维
拖厂	拖拉机制造厂
彩印	彩色印刷
助工	助理工程师
农林畜	农业林业畜牧业
影评	电影评论
私宅	私人住宅
林土所	林业土壤研究所
建商	建筑商
世界劳联	世界劳工联合会
街居	街道居民
职棒	职业棒球
节耗	节约能耗
国际世协	国际世界语协会
书研班	书法绘画艺术研讨班
党办	党委办公厅室
地检署	地方法院检察署
监管	监督管理
海协会	大陆海峡两岸关系协会
公民所	公民律师事务所
农函大	农业函授大学
农技校	农业技术学校
世排赛	世界排球锦标赛
音美	音乐美术
小教联	小学教师联合会
大专生	大学专科学生
国际棒协	国际棒球协会
史著	历史著作
年胀率	年度通货膨胀率
形象办	形象办公室
田联	田径联合会
电镜	电子显微镜
敌占区	敌方占领区
人大会	人民代表大会
党政	党组织政府部门
棉研所	棉花研究所
成棒	成人棒球
妇联会	妇女联合会
市况	市场状况
环保部	环境保护部
技协	技术协会
农水资源	农业水利资源
计财部	计划财务部
农校	农业技术学校
动源	动力源
现势	现实形势
铁纪	铁路纪律
影视圈	电影电视圈
热作	热带作物
界野	界限分野
私物	私人物品
外轮	外籍轮船
实务	实际事务
商博会	商品博览会
厂医	工厂医生
智障	智力障碍
护协	护士协会
干休所	干部休养所
武协	武术协会
航材所	航空材料研究所
歧见	分歧意见
海司	海军司令部
田协	田径协会
专区社	专区供销合作社
中教联	中学教师联合会
实绩	实际业绩
职运会	职工运动会
侨领	侨民领袖
美影	美术电影制片厂
房委会	房屋顾问委员会
全运	全运会
个展	个人作品展
团友	旅游团朋友
城工部	城市工作部
证券委	证券委员会
企财	企业财产
股市	股票市场
林型	森林类型
世局	世界局势
作代会	作家代表大会
羽锦赛	羽毛球锦标赛
建研院	建筑设计研究院
女师大	女子师范大学
电联	国际电信联盟
职业培训	职业技术培训
联汇	联系汇率
合同工	合同制工人
政研室	政策研究室
商院	商学院
商交会	商品交易会
科委会	科学研究委员会
航管中心	航务管理中心
政制	政治制度
品资所	品种资源研究所
社科联	社会科学界联合会
诗编	诗歌编辑
国训队	国家集训队
军代表	解放军代表
医科院	医学科学院
女单	女子单打
亲随	亲信随从
动植	动物植物
童影	儿童电影制片厂
粮贴	粮食补贴
文体委	文艺体育委员
社科院	社会科学院
渔会	渔民协会
影协	摄影家协会
劳动市场	劳动力市场
陆架	大陆架
客量	客流量
医训班	医疗培训班
小教	小学教师
市经	市场经济
照主	执照主人
质安员	质量安全员
社文处	社会文化管理处
人音社	人民音乐出版社
医药局	医药管理局
全运会	全国运动会
基地办	基地办公室
人口所	人口研究所
粮油肉	粮食油料肉制品
环委会	环境保护委员会
儿基会	儿童少年基金会
渔技员	渔业技术员
科展	科学知识展览会
商银	商业银行
手纺	手工纺织
技工	技术工人
农院	农业学院
液体导弹	液体推进剂导弹
地热	地球热能
儿麻	小儿麻痹症
卡带	卡式磁带
环保法	环境保护法
儿影	儿童电影制片厂
电传机	电传打字机
函电	信函电话电报
乡府	乡政府
里委	里弄委员会
国管局	国家管理局
艺委	艺术委员会委员
体模	人体模型
时长	时间长度
教职	教员职员
美院	美术学院
青企协	青年企业家协会
科研	科学研究
乒联	乒乓球联合会
武备	武器装备
全民	全体公民
郊县	城市郊区县
声光电	声音灯光电
行务	银行业务
孤寡	孤儿寡妇
视圈	电视演职员圈
邮费	邮政资费
财校	财政学校
警特	警察特务
医管局	医疗管理局
国际中学生体联	国际中学生体育联合会
食研所	食品工业研究所
警厅	警察厅
警力	警务力量
羽球	羽毛球
城管办	城市管理办公室
林管局	林业管理局
船管组	船只管理组
青少部	青少年部
孤幼	孤儿幼童
农建队	农民建筑队
债息	债券利息
史语所	历史语言研究所
女足	女子足球
轻工	轻工业
职代会	职工代表大会
农房	农民住房
纪委	纪检委
电贴	电力补贴
农牧渔机	农业牧业渔业机械
封资修	封建主义资本主义修正主义
农保	农村医疗保险
中大	中央大学
农会	农民协会
军政警宪	军队政府警察宪兵
数图网	数字图书网
人大	人民代表大会
节假	节日假日
原辅	原料辅料
友促会	国际友谊促进会
化轻	化学轻工业
污源	污染源
国际路联	国际道路联合会
县社	县供销合作社
航图	航空图
森经局	森林经济管理局
劳动资源	劳动力资源
财委会	财政委员会
乒球	乒乓球
航校	航空学校
班代	班级成员代表
核反应堆	原子核裂变反应堆
妇联办	妇女联合会办公室
民警	人民警察
市运会	市运动会
科研所	科学技术研究所
昆丑	昆曲丑角
检具	产品检验用具
粮市	粮食市场
农经办	农业经济办公室
丝绸公司	丝绸工业公司
汽渡	汽车轮渡
女中	女子中学
交管站	交通管理检查站
新研所	新闻研究所
国际体联	国际体操联合会
政经文史	政治经济文学历史
团代会	共青团代表大会
节能	节约能源
期指	期货指数
券商	证券商
货源	货物来源
水环监	水利环境监测
舞院	舞蹈学院
纪检组	纪律检查组
汽摩	汽车摩托车
农经	农业经济
农技站	农业技术推广站
彩照	彩色照片
林牧渔	林业牧业渔业
中委会	中央委员会
市场办	市场办公室
速测	快速检测
政法办	政法委员会办公室
少代会	少年代表大会
医工院	医药工业研究院
领海权	领海主权
竹艺	竹制品工艺
高检	高检院
柔锦赛	柔道锦标赛
医大	医科大学
纺织部	纺织工业部
花协	花卉协会
房贴	住房补贴
港口费	港口使用费
库管员	仓库保管员
防尘	防止灰尘
党政军企	党组织政府部门军队企业
大教联	大学教授联谊会
农业社	农业生产合作社
果蔬	水果蔬菜
邮司	邮票公司
乐评	音乐评论
电信局	电信管理局
个体劳协	个体劳动者协会
农运会	农民体育运动会
男曲	男子曲棍球
支书	支部书记
农林牧渔	农业林业牧业渔业
职初	职业初中
电网	电力网
地大	地质大学
民舞	民族舞蹈
税警	税务警察
速查法	快速查找法
汽配	汽车配件
手外科	手术外科
民俗	民间风俗
编委会	编辑委员会
股本	股份资本
股交所	股票交易所
工厦	工业大厦
音代会	音乐家代表大会
世乒赛	世界乒乓球锦标赛
市值	市场价值
果品办	果品办公室
女排	女子排球
时评	时事评论
省博	省博物馆
军医大	军事医科大学
基金委	基金委员会
主秘	主任秘书
薪津	薪金津贴
物校	物资学校
热作所	热带作物研究所
集管局	集体企业管理局
女排赛	女子排球锦标赛
企经委	企业经济委员会
矿警	矿山警察
工联	工联会
文编室	文学编辑室
光电所	光电技术研究所
政校	政治学校
政教处	政治教育处
曲协	曲艺工作者协会
军干校	军人干部学校
体校	体育学校
职监员	职工物价监督员
金饰	黄金首饰
计生户	计划生育户
免疫	免疫性
商团	商界业务代表团
篮联	篮球联合会
佛联	佛教徒联谊会
步校	步兵学校
商中	商业中学
少教所	少年管教所
奥项	奥运会项目
党政办	党政办公室
桥艺	桥牌艺术
城管委	城市管理委员会
剧协	戏剧家协会
物业办	物业办公室
校纪	学校纪律
考纪会	考纪委员会
农电	农村用电
国际羽联	国际羽毛球联合会
金交所	金融交易所
城运会	城市运动会
农工副	农业工业副业
助检员	助理检察员
工艺过程	工艺技术过程
央行	中央银行
女小	女子小学
干训队	干部集训队
测温	测量温度
塑膜	塑料薄膜
炮校	炮兵学校
粮交会	粮食交易会
党政工	党组织行政部门工会组织
塑瓶	塑料瓶
农副工	农业副业工业
冰期	冰川时期
标贴	商标招贴
环保	环境保护
城雕委	城市雕塑委员会
农广校	农业广播电视学校
女俘	女性俘虏
中博	中央博物院
林管站	林业管理站
服研所	服装研究所
户政	户籍政策
医办室	医生办公室
国新社	国际新闻社
外事	外交事务
军仪	军人仪表
弹速	子弹速度
外经部	外经贸部
地税	地方税务
海贝类	海产贝壳类
交长	交通部长
粮划署	粮食规划署
货邮	货物邮件
税政	税收政策
食品办	食品工业办公室
青工	青年工人
院校所	学院学校研究所
星战	星球大战
铁中	铁路中学
公教	公务教学
胶化	胶体化学
世青节	世界青年联欢节
校董	学校董事会董事
货客	货物旅客
童星	儿童电影明星
智龄	智力年龄
体语	身体语言
测控	监测控制
新影	中央新闻纪录电影制片厂
钢混	钢筋混凝土
冰协	冰球协会
根雕	树根雕刻
国家经委	国家经济委员会
待青	待业青年
女花	女子花剑
工办	工业办公室
驾照	驾驶执照
群艺馆	群众艺术馆
社团办	社团办公室
竞体	竞技体育
化危品	化学危险品
世羽赛	世界羽毛球锦标赛
金商	黄金经营商
城运村	城市运动会运动员村
农技协	农业技术协会
医患	医生患者
空政	空军政治部
盒带	盒式录音带
男中	男子中学
政工组	政治工作组
民委	民族事务委员会
石化	石油化工
民谚	民间谚语
影人	电影界人士
知青	知识青年
激光所	激光技术研究所
劳顾会	劳资顾问委员会
国际曲联	国际曲棍球联合会
文艺界	文学艺术界
全民企业	全民所有制企业
交管部门	交通管理部门
工博会	工业博览会
民曲	民间乐曲
戏工室	戏剧工作室
特检站	经济特区检查站
声韵	声母韵母
男花	男子花剑
手协	手球协会
警员	警务人员
社科	社会科学
交警	交通警察
议联	议员联盟
院纪	学院纪律
质管员	质量管理员
融政	金融政治
女双	女子双打
工资系数	工资等级系数
女工部	妇女工作部
艺校	艺术学校
工企	工业企业
影机	电影放映机
农化	农业化学
林校	林业学校
责编	责任编辑
质保书	质量保证书
钢院	钢铁学院
航联	航空联合会
文史哲	文学史学哲学
传媒	传播媒介
电挂	电报挂号
科代会议	科学工作者代表会议
侨务处	华侨事务处
农林厅	农业林业厅
地学	地球科学
劳联	劳工联合会
政工部	政治工作部
市百	市百货公司
军需所	军需装备研究所
半导体	半导体收音机
私财	私人财产
农金	农村金融
棉站	棉花收购站
蔬果	蔬菜水果
裁委会	裁判委员会
拳协	拳击协会
农军	农民自卫军
地矿	地质矿产
特稿	特写稿件
交检站	交通管理检查站
外银	外资银行
博导	博士生导师
动效	动作效果
邮掮	邮票掮客
机器人所	机器人研究所
外币	外国货币
国际棋联	国际象棋联合会
人武	人民武装
支委	支部委员会委员
手联	手球联合会
乡医	乡村医学
空模	航空模型
青军会	青年军人联合会
村代会	村民代表大会
护校	护士学校
男团	男子团队
植物所	植物研究所
分委	分委会
车配	车辆配件
民联	三民主义同志联合会
农林水	农业林业水利
热工学	热能工程学
泳队	游泳队
参委	参事委员会
导游女	导游女郎
电感	电子感应
橡塑品	橡胶塑料制品
国商	国际商业信贷银行
省建公司	省建筑工程公司
冶金所	冶金研究所
小四轮	小四轮拖拉机
外委	外事委员会
智商	智力商数
计算所	计算机技术研究所
土肥所	土壤肥料研究所
炮指	炮兵指挥部
空调	空气调节
学则	学生守则
妇救会	妇女救国会
计财处	计划财务处
环情	环境情况
老区办	老区办公室
化物	化学物理
提案委	提案委员会
毒副	毒品副作用
外债	外国债务
职棒球员	职业棒球队员
党政军警民	党组织政府部门军队警察民众团体
航线	航空线
廉政办	廉政办公室
金属所	金属研究所
党团	党组织团组织
武委会	武术委员会
书艺	书法艺术
群团	群众性团体
世经所	世界经济研究所
药械科	药品器械科
视保屏	视力保护屏
市府办	市政府办公室
船模	舰船模型
电子科大	电子科技大学
轻工部	轻工业部
权责利	权力责任利益
律联	律师联盟
县人大	县人民代表大会
建工	建筑工程
地矿部	地质矿产部
农救	农民救国会
收汇	收入外汇
流感	流行性感冒
耶教	耶稣教
村干	村干部
化工公司	化学原料工业公司
国际货约	国际铁路货物运送公约
体院	体育学院
商办	商务办事处
女垒	女子垒球
省队	省代表队
男篮	男子篮球
旅业	旅游业
刊大	刊授大学
人身险	人身保险
盲协	盲人协会
总产	总产量
中研院	国民党中央研究院
外语系	外国语言文学系
篮赛	篮球赛
黑工	黑市劳工
空压机	空气压缩机
党政军警	党组织政府部门军队警察
担运队	担架运输队
生资站	生产资料站
土管局	土地管理局
功模	功臣模范
等离子刀	等离子体手术刀
中行	中央银行
助研	助理研究员
个唱	个人演唱会
市管处	市政工程管理处
空政文工团	空军政治部文艺工作团
社福	社会福利
人险	人身保险
艺院	艺术学院
盒饭	盒装饭菜
国际垒联	国际垒球联合会
节材	节约材料
伙委	伙食委员
军工	军事工业
全委	全国委员会
信用联社	信用联合社
足协	足球协会
旱涝	旱灾涝灾
妇干	妇女干部
女曲	女子曲棍球队
文化局	文化事业管理局
像带	录像带
政圈	政治圈子
棉织	棉纺织
舰院	舰艇学院
菌肥	细菌肥料
经警	经济警察
员额	人员数额
车险	汽车保险
汽配城	汽车配件城
教辅	教学辅导
黄毒	黄色毒素
拖配厂	拖拉机配件厂
行署	行政公署
女大	女子大学
农本	农业成本
管控	管理控制
农林委	农林委员会
主委	主任委员
孕产	孕妇产妇
资产	资金财产
电算	电子计算
站调	航站调度室
八办	八路军办事处
农政部	农村政治部
内航局	内河航运局
股价	股票价格
船位	船位置
科社部	科学社会部
厂纪	工厂纪律
峨影	峨嵋电影制片厂
文博院	文物博物院
男高	男高音
下议员	下议院议员
商储	商品储运
乡企	乡镇企业
商况	商业情况
报章	报刊文章
中医药局	中医药品管理局
航管所	航务管理所
外研所	外国语言研究所
航电	航空电磁法
胰石	胰腺结石
税企	税务企业
软交会	软件交易会
汽教	汽车教练
五四三	五讲四美三热爱
文宣队	文艺宣传队
橡塑厂	橡胶塑料厂
电视机	电视接收机
老协	老年人协会
机械委	机械工业委员会
农中	农业中学
世青会	世界青年运动会
西画	西洋画
少足	少年足球
公铁	公路铁路
农博会	农业博览会
交行	交通银行
青少体校	青少年体育运动学校
建材厂	建筑材料厂
影联	电影工作者联盟
商战	商业战争
关余	关税余额
网膜	视网膜
市宫	市工人文化宫
鳏寡	鳏夫寡妇
马列主义	马克思列宁主义
社政	社会政治
仓租	仓库租金
校企	学校企业
政指	政治指导员
街总	街坊总会
科艺楼	科技艺术楼
艺大	艺术大学
中央社	中央通讯社股份有限公司
房务部	客房服务部
盲校	盲人学校
地价	土地价格
话研会	话剧研究会
铁联	国际铁路联盟
托幼	托儿所幼儿园
行风	行业作风
妇干班	妇女干部培训班
修院	修道院
宪制科	宪制事务科
仔裤	牛仔裤
军邮	军队系统邮政
彩电	彩色电视
土管员	土地管理员
农工部	农村工作部
纺品	纺织品
时事社	时事通讯社
语言所	语言研究所
摩协	摩托车协会
机管局	机场管理局
影星	电影明星
校工	学校工人
话线	电话线
银贸	银行外贸
汽技改	汽车技术改造
电总	电信总局
国家计委	国家计划委员会
中委	中央委员
桥联	桥牌联合会
史训	历史教训
参茸	人参鹿茸
文摘	文章摘要
体联	体育联合会
实态	实际状态
妇代会	妇女代表大会
书报刊	图书报纸期刊
摄协	摄影家协会
水阻	水流阻力
女团	女子团体
乡企局	乡镇企业局
林牧农	林业牧业农业
轻校	轻工业学校
青干班	青年干部培训班
前委会	前敌委员会
机场	飞机场
生化所	生物化学研究所
机检	计算机检索
中队委	少先队中队委员会委员
省检	省检察院
智能所	智能研究所
文委	文艺委员会
人权委	人权委员会
省总	省总工会
影艺	电影艺术
拖配	拖拉机配件
商职校	商业职业学校
曲作家	词曲作家
工展会	工业展览会
开播	开始播放
商游	商业旅游业
机绣	机器刺绣
居委会	居民委员会
总编	总编辑
核研所	核能研究所
国标	国家标准
科技户	科技示范户
农能办	农业能源办公室
流水线	流水生产线
税制	税收制度
皮博会	皮革博览会
控区	控制区
中电	中央电影企业股份有限公司
警匪	警察匪徒
理事会	理事委员会
海校	海军学校
太阳电池	太阳能电池
农科	农业科学
水电大	水利电力大学
官校	军官学校
林牧副渔	林业牧业副业渔业
农研会	农业经济研究会
国际网联	国际网球联合会
粮油	粮食油料
话簿	电话簿
荣校	荣誉军人学校
拳委	拳击委员会
残部	残余部队
舞师	舞蹈教师
煤管局	煤炭管理局
农牧局	农业畜牧业局
路服	铁路制服
成果办	科学研究成果办公室
通胀率	通货膨胀率
饭贴	饭钱补贴
家肥	农家肥料
交建公司	交通建筑工程公司
路警	铁路警察
城管	城市管理
名权位	名誉权利地位
声镜	声学显微镜
固体导弹	固体推进剂导弹
质标	质量标准
足联	足球联合会
药商	药品商
性征	性别特征
节市	节日市场
国际帆联	国际帆船联盟
农救会	农民救国会
社党	社会民主党
工代大会	工人代表大会
党群	政党人民群众
哲社	哲学社会科学
金价	黄金价格
房展会	住房展览会
银联	银行职员联合会
景观图	景观地图
校运会	学校运动会
金融展	金融展览会
军列	军人列车
财干院	财政干部学院
试婴	试管婴儿
寄研所	寄生虫病研究所
律管司	律师管理司
工装	工艺装备
伙补	伙食补贴
世青田径赛	世界青年田径锦标赛
军政民	军队政府人民
广电报	广播电视报
劳务办	劳动力管理服务办公室
农电站	农村电站
国税所	国家税务所
精油	香精油
女校	女子学校
校委会	校务委员会
财年	财政年度
国际冰联	国际冰球联合会
食疗	饮食疗法
航摄机	航空摄像机
体协	体育协会
药物所	药物研究所
体工队	体育工作队
商联会	全国商业联合会
经联社	经济联合社
农技	农业技术
科工办	科技工业办公室
持平	保持平衡
商台	商业电台
热工	热能工程
森工	森林工业
外文系	外国语言文学系
乡企办	乡镇企业办公室
老年委	老年人委员会
电玩	电动玩具
青干	青年干部
国际划联	国际划艇联合会
首图	首都图书馆
支委会	党支部委员会
话机	电话机
残童	残疾儿童
金市	黄金市场
党政军	党组织政府部门军队
世界工联	世界工会联合会
师院	师范学院
契税	契约税
教德	教师职业道德
人卫站	人民卫生站
航母	航空母舰
税银	税务银行
土建	土木建筑
建协	建筑协会
人道立场	人道主义立场
编导演	编剧导演演员
色温	颜色温度
马哲史	马克思主义哲学史
农话	农村电话
保单	保险单
牛罐	牛肉罐头
森警	森林警察
国列	国际旅客列车
外军	外国军队
编委	编辑委员会委员
煤化工	煤炭化工
市政局	市政工程管理局
色斑	色素斑点
高新区	高新技术产业开发区
家托	家庭托儿所
市编委	市编辑委员会
城管局	城市管理局
现代舞	现代派舞蹈
国基会	国际货币基金会
党政军民	党组织政府部门军队民众团体
义消	义务消防队
片库	影片仓库
美校	美术学校
空港	航空港
衣裤	衣服裤子
股值	股票价值
共管	共同管理
外秘	外交秘书
视帝	电视剧皇帝
文工队	文化艺术工作队
垒协	垒球协会
船院	船舶学院
科任	科考任务
唯物史观	唯物主义历史观
外院	外国语学院
煤科院	煤炭科学院
软件所	软件研究所
总政	红军总政治部
个税	个人所得税
牡丹卡	牡丹信用卡
资讯	资源讯息
合作所	合作制律师事务所
反属	反革命分子家属
地磁	地球磁性
医技	医疗技术
电控	电气控制
邮市	邮票市场
林研所	林业研究所
农林科学院	农业林业科学院
院办	院长办公室
棒协	棒球协会
舞协	舞蹈家协会
粮经	粮食经济
高校	高等院校
耗时	耗费时间
扇超	扇形超声波
侨团	华侨团体
医助	医生助理
曲论	词曲理论
警备	警务装备
农林水利	农业林业水利
三青团	三民主义青年团
国补	国家补贴
高能所	高能物理研究所
国土局	国家土地管理局
社青	社会青年
艺研院	艺术研究院
住宅办	住宅办公室
税票	税收票证
军婚	军人婚姻
外专局	外国专家局
专修班	专业进修班
女监	女子监狱
超市	超级市场
城隧	城市隧道
体彩	体育彩票
国际赛联	国际赛艇联合会
团干	共青团干部
机织	机器纺织
质监员	质量监督员
工纠	工人纠察
青妇	青年妇女
被装	棉被服装
督理	监督管理
三轮	三轮车
科社	科学社会主义
航委会	航空委员会
电管所	电子管理所
低噪	低噪声
国图联	国际图书联合会
乒队	乒乓球队
音校	音乐学校
花市	花卉市场
和约	和平条约
卫片	卫星照片
首信	首都信息技术有限公司
企银	企业银行
商贷	商业贷款
炮院	炮兵学院
库券	国库券
医委会	医学委员会
高新	高新技术
地产	土地资产
柠茶	柠檬茶
文理工	文科理科工科
规土局	规划土地局
交运局	交通运输管理局
男服	男子服装
海榴	海石榴
参会	参加会议
新协	新闻工作者协会
家纺	家庭纺织
青影	青年电影制片厂
市队	市代表队
彩管	彩色显像管
外籍	外国国籍
农合工	农民合同制工人
科干局	科技干部局
中央音院	中央音乐学院
校团委	学校共青团委员会
领馆	领事馆
总工	总工程师
品学	品行学业
汇商	外汇商人
局地	局部地区
华裔	华人后裔
野政	野战军政治部
监管会	监督管理委员会
残运会	残疾人运动会
运势	命运形势
村委	村民委员会
财保	财政保险
物价局	物价管理局
影帝	电影皇帝
海科	海洋科学
空管局	空中交通管理局
人医	人民医院
建陶	建筑陶瓷
影后	电影皇后
音协	音乐家协会
男羽队	男子羽毛球队
农资办	农业生产资料办公室
省运会	省体育运动会
航管站	航务管理站
房协	房屋协会
残协	残疾人体育协会
园林办	园林办公室
旱作	旱地作物
岸炮	海岸炮
思政	思想政治
农经委	农业经济委员会
政务	行政事务
企业办	企业办公室
班委会	班级委员会
文史哲经	文学史学哲学经济学
地表	地球表面
师大	师范大学
男排	男子排球
股指	股价指数
期市	期货市场
药具	医药器具
职数	职位数量
机织厂	机器纺织厂
毒贩	毒品贩子
检方	检察院方面
外空	外层空间
城雕	城市雕塑
企协	企业家协会
文研所	文学研究所
空冷设备	空气冷却设备
社群	社会群体
个协	个体协会
红属	红军家属
科艺宫	科技艺术宫
现况	现实情况
体委	国家体育运动委员会
影视录	电影电视录像
证交所	证券交易所
卫协	卫生工作者协会
妇女会	妇女协会
移民办	移民办公室
党支	党支部
虫草	冬虫夏草
农代会	农民代表大会
股评	股市评论
艺文	艺术文化
行止	行为举止
犯属	犯人家属
军事医科院	军事医学科学院
坑道	坑道工事
电院	电子工程学院
助审员	助理审判员
民力	民众力量
商服	商业服务业
企办	企业办公室
根艺	根雕艺术
政银企	政府银行企业
农协会	农民协会
航院	航空学院
钢混结构	钢筋混凝土结构
垒联	垒球联合会
生物所	生物研究所
家财险	家庭财产保险
煤化所	煤炭化学研究所
警署	警察署
乒羽	乒乓球羽毛球
商住房	商业住房
油雕院	油画雕塑院
标煤	标准煤
文委会	文艺委员会
工兵农	工人士兵农民
市交委	市交通委员会
幼保	幼童保险
技校	技工学校
中戏	中央戏剧学院
中央财院	中央财政金融学院
国地税	国家地方税收
电教办	电化教学办公室
原子能所	原子能研究所
炮团	炮兵团
石油部	石油工业部
国统区	国民党统治区
单宿	单身宿舍
能源办	能源办公室
牌委会	牌照委员会
大篮联	大学生篮球联合会
全漫协	全国漫画家协会
大体协	大学生体育协会
通膨率	通货膨胀率
业权	物业所有权
侨知联谊会	侨界知识分子联谊会
体工站	体育工作站
降耗	降低消耗
技交所	技术交易所
调温	调节温度
法制委	法制委员会
夜大	夜大学
擂赛	擂台赛
外资	外国资本
演星	演员明星
财经委	财政经济委员会
宗教局	宗教事务管理局
院务部	学院事务部
单产	单位面积产量
机油	机械油
年资	年龄资历
特工	特务工作人员
世博会	世界博览会
厂办	厂长办公室
关检	海关检查
农经所	农业经济研究所
舞训班	舞蹈训练班
县人委	县人大委员会
民宗委	民族宗教委员会
长宽	长度宽度
科管	科学管理
外烟	外国香烟
物总	物资总公司
消委	消费者委员会
声光视效	声音灯光视觉效果
水管费	水利管理费
商经	商业经济
外管局	外事管理局
义工	义务工作者
潜质	潜力素质
兵运线	兵站运输线
姿彩	姿态色彩
古研所	古迹研究所
有研	有色金属研究所
助编	助理编辑
个体户	个体工商户
文办	文化办公室
电教	电化教学
国际马联	国际马术联合会
社联	社会科学界联合会
煤电油运	煤炭工业电力工业石油工业运输业
学工部	学生工作部
武联	武术联合会
世妇联	世界妇女联合会
家电	家用电器
节本降耗	节约成本降低能耗
艺代会	艺术家代表会
省图	省图书馆
玻纤	玻璃纤维
农牧渔	农业牧业渔业
美编	美术编辑
果研所	水果研究所
家纠	家庭纠纷
车管科	车辆管理科
男网	男子网球
计控处	计量控制处
医协	医学协会
模具所	模具技术研究所
家计所	家庭计划研究所
车况	车辆状况
干管处	干部管理处
农经站	农业经济站
实效	实际效果
公边	公安边防
规费	规划费用
儿影厂	儿童电影制片厂
国际隧协	国际隧道协会
大众传媒	大众传播媒介
妇代	妇女代表
师德	教师道德
交市	交易市场
社情	社会情况
社会购买力	社会商品购买力
律协	律师协会
工艺美校	工艺美术学校
和委会	和平委员会
林机厂	林业机械厂
经院	经济学院
工疗	工人疗养院
行员	银行职员
动检站	动物检疫站
责权利	责任权利利益
政宣科	思想政治宣传科
民运	少数民族运动会
国大	国民代表大会
集体工	集体所有制工人
学联	学生联合会
资源委	资源委员会
债信	债务信用
体博会	体育博览会
花博会	花卉博览会
文宣部	文化宣传部
纺工	纺织工业
军报	解放军报
信贷	信用贷款
税基	课税基础
物委	物资委员会
新影厂	中央新闻纪录电影制片厂
粮仓	粮食仓库
节能办	节约能源办公室
业委会	业主委员会
鞭花	鞭炮礼花
化轻公司	化学轻工业公司
委办	委员会办公室
盟军	同盟国军
电仪局	电子仪表工业局
海俱	海员俱乐部
人美	人民美术出版社
农林牧副渔	农业林业牧业副业渔业
干管	干线管道
街办	街道办事处
武星	武打明星
工属	职工家属
全代会	全国代表大会
成中	成人中学
控会	控制会议
语协	语言文字工作者协会
邮识	邮票常识
技委	技术委员会
心梗	心肌梗塞
行警	银行警卫
班委	班级委员会委员
干修班	干部进修班
田锦赛	田径锦标赛
街委	街道委员会
冷项	冷门项目
院党办	院党委办公室
建机厂	建筑机械厂
图联	国际图书馆协会联合会
供销社	供销合作社
视协	电视艺术家协会
速算	快速计算
财金	财政金融
中控室	中央控制室
舞团	舞蹈艺术团
围协	围棋协会
航炮	航空机关炮
难侨	难民华侨
农电工	农村电工
残困户	残疾人困难户
经理办	经理办公室
疗效	医疗效果
银膜	银光塑料薄膜
企务	企业事务
星联	星际联盟
海缆	海底电缆
粮站	粮油管理站
寿险	人寿保险
舞星	舞蹈明星
军警	军队警察
人劳局	人事劳动局
航博会	航空博览会
机修厂	机械修配厂
市政府办	市政府办公室
污水厂	污水处理厂
财大	财经大学
税干	税务干部
技交	技术交易
邮编	邮政编码
党史办	党史办公室
医工所	医药工业研究所
电解液	电解质溶液
函大	函授大学
煤质	煤炭质量
芭科	芭蕾舞科
省府	省政府
女柔	女子柔道
市人委	市人民委员会
世足赛	世界杯足球赛
影圈	电影圈
校秩部	学校秩序部
粮农	粮食农业
北约	北大西洋公约组织
农险	农业保险
电业	电力工业
空调器	空气调节器
农林水产	农业林业水产
吧台	酒吧台
特嫌案	特务嫌疑案件
临工	临时工
汽贷	汽车贷款
编校	编辑校对
国税局	国家税务局
战略办	战略办公室
理工	理工科
食市	食品市场
环卫所	环境卫生所
房源	住房来源
化废	化学废物
少体	少年体育
专署	专员公署
影视记协	电影电视记者协会
工效	工作效率
烈属	烈士家属
技研会	科学技术研究会
足锦赛	足球锦标赛
科技教界	科学技术教育界
冶工部	冶金工业部
集体办	集体事业办公室
货币战	货币战争
汽齿厂	汽车齿轮厂
生资	生产资料
译训班	翻译人员训练班
华校	华侨学校
兵工部	兵器工业部
建材局	建筑材料工业局
国际舞	国际标准舞
社文委	社会文化委员会
空乘	航空乘务
农修厂	农业机械修配厂
钢研所	钢铁研究所
农信联社	农村信用联社
聋校	聋哑学校
机电办	机械电子工业办公室
军干所	军队干部休养所
生产社	农业生产合作社
工时	工作时间
体专班	体育专修班
侨校	华侨学校
煤炭部	煤炭工业部
棉花所	棉花研究所
实控线	实际控制线
大桥局	大桥建设工程局
外长	外交部长
羽联	羽毛球联合会
政办	政府办公室
土化	土壤化学
社保基金	社会保险基金
亚运	亚运会
男乒	男子乒乓球
众院	众议院
军委会	军事委员会
动物所	动物研究所
群体处	群众体育处
体师院	体育师范学院
摩联	摩托车联合会
农机校	农业机械学校
国科大	国防科技大学
中财委	中央财政经济委员会
书画影戏	书法绘画电影戏剧
人寿险	人寿保险
绒癌	绒毛膜癌
科交会	科技成果交易会
建总	城建总公司
农林水牧	农业林业水利牧业
