一秘	一等秘书
上京	上海京剧院
上博	上海博物馆
上工	上海工业
上航	上海航空公司
专储	专项储备
专干	专职干部
专才	专业人才
专署	专员公署
专责	专门负责
世行	世界银行
世贸	世界贸易
东协	东南亚国家协会
东汽	东风汽车公司
东航	东方航空公司
丝路	丝绸之路
严控	严格控制
严管	严格管理
个唱	个人演唱会
个税	个人所得税
个贷	个人贷款
中总	香港中华总商会
中戏	中央戏剧学院
中控	中央控制
中直	中央直属机关
中院	中级人民法院
临客	临时旅客列车
临建	临时建筑
主因	主要原因
主控	主要控制
主秘	主任秘书
举发	检举揭发
乒协	乒乓球协会
乙脑	乙型脑炎
书艺	书法艺术
二汽	第二汽车制造厂
二秘	二等秘书
亚乒	亚洲乒乓球
亚姐	亚洲小姐
交大	交通大学
交行	交通银行
产能	生产能力
产销	生产和销售
人武	人民武装
人防	人民防空
从商	从事商业
众院	众议院
体协	体育协会
体工	体育工作
体彩	体育彩票
体校	体育学校
体院	体育学院
佛协	佛教协会
作训	作战训练
修宪	修改宪法
停售	停止销售
停播	停止播放
健检	健康检查
党史	党的历史
党工	党务工作
党建	党的建设
党纪	党的纪律
全麻	全身麻醉
公交	公共交通
公关	公共关系
公判	公开宣判
公厕	公共厕所
公审	公开审判
公屋	公共房屋
公德	公共道德
公投	公民投票
公铁	公路铁路
共保	共同保护
共建	共同建设
共治	共同治理
共管	共同管理
共荣	共同繁荣
关员	海关人员
兵总	兵器工业总公司
内审	内部审计
内控	内部控制
军体	军事体育
军力	军事力量
军情	军事情报
军控	军备控制
军援	军事援助
军机	军事机密
军管	军事管制
军训	军事训练
军贸	军火贸易
农地	农业用地
农大	农业大学
农房	农民住房
农技	农业技术
农电	农村用电
农科	农业科学
农经	农业经济
农话	农村电话
农贷	农业贷款
农资	农业生产资料
农运	农民运动
农险	农业保险
减亏	减少亏损
减让	减税让利
分获	分别获得
刑侦	刑事侦查
刑庭	刑事法庭
刑拘	刑事拘留
刑释	刑满释放
初教	初等教育
判监	判处监禁
制程	制造过程
前指	前线指挥部
劳保	劳动保护
劳改	劳动改造
劳教	劳动教养
劳模	劳动模范
勒赎	勒索赎金
化武	化学武器
北体	北京体育大学
北大	北京大学
北展	北京展览馆
北影	北京电影制片厂
医大	医科大学
医技	医疗技术
医界	医疗界
协处	协助处理
协寻	协助寻找
南大	南京大学
南师	南京师范大学
博导	博士生导师
卫校	卫生学校
卫片	卫星照片
印尼	印度尼西亚
厦大	厦门大学
参会	参加会议
参演	参加演出
参训	参加训练
参访	参观访问
参试	参加试验
参院	参议院
友协	友好协会
反帝	反对帝国主义
反战	反对战争
受托	接受委托
受阅	接受检阅
叙军	叙利亚军队
古史	古代历史
台企	台湾企业
台大	台湾大学
台生	台湾学生
台胞	台湾同胞
吉大	吉林大学
呼市	呼和浩特市
和约	和平条约
和谈	和平谈判
商检	商品检验
商誉	商业信誉
商贷	商业贷款
善信	善男信女
国企	国有企业
国基	国家基础
国控	国家控制
国贸	国际贸易
土军	土耳其军队
土改	土地改革
地价	土地价格
地勘	地质勘查
地埋	地下埋藏
地学	地球科学
地矿	地质矿产
坚拒	坚持拒绝
城建	城市建设
城管	城市管理
城郊	城市郊区
基建	基本建设
增幅	增长幅度
增支	增加支出
增收	增加收入
增税	增加税收
增编	增加编制
增速	增长速度
复交	恢复外交关系
复健	恢复健康
外事	外交事务
外军	外国军队
外空	外层空间
外航	外国航空公司
外销	对外销售
外需	外部需求
大本	大学本科
央行	中央银行
奥体	奥林匹克体育
女中	女子中学
女举	女子举重
女乒	女子乒乓球队
女单	女子单打
女双	女子双打
女团	女子团体
女垒	女子垒球
女曲	女子曲棍球队
女柔	女子柔道
女校	女子学校
女花	女子花剑
女超	女子超级
女足	女子足球
委办	委员会办公室
委培	委托培养
婉拒	婉言拒绝
婚龄	结婚年龄
嫌犯	嫌疑犯
学联	学生联合会
学运	学生运动
安保	安全保卫
安检	安全检查
安盟	争取安哥拉彻底独立全国联盟
完小	完全小学
定存	定期存款
实效	实际效果
审案	审理案件
宣导	宣传引导
宣教	宣传教育
家教	家庭教育
家财	家庭财产
小巴	小型巴士
尤杯	尤伯杯
尼共	尼泊尔共产党
尿检	尿样检查
局地	局部地区
展馆	展览馆
川航	四川航空公司
巡展	巡回展出
巡讲	巡回演讲
工体	北京工人体育场
工大	工业大学
工总	工业总会
工效	工作效率
工时	工作时间
工美	工艺美术品
巨资	巨额资金
市况	市场状况
市务	市场业务
师专	师范专科学校
师大	师范大学
师院	师范学院
帮贫	帮助贫困户
平叛	平息叛乱
建商	建筑商
建外	建国门外
建工	建筑工程
建材	建筑材料
建管	建筑管理
开行	开发银行
引智	引进国外智力
引资	引进资金
强震	强烈地震
彩印	彩色印刷
彩照	彩色照片
影业	电影业
影带	录影带
影星	电影明星
律协	律师协会
心梗	心肌梗塞
心防	心理防线
息率	利息率
成教	成人教育
成飞	成都飞机
战训	战备训练
户政	户籍政策
打私	打击走私活动
打防	打击和防范
执纪	执行纪律
扩招	扩大招生
扫盲	扫除文盲
批建	批准建设
批捕	批准逮捕
技协	技术协会
技改	技术改造
技校	技工学校
投建	投资建设
投运	投入运行
抗战	抗日战争
抬价	抬高价格
拉美	拉丁美洲
拒付	拒绝支付
拒收	拒绝接收
拳赛	拳击比赛
排协	排球协会
排管	排水管道
控申	控告申诉
援藏	支援西藏
搜证	搜集证据
摘金	摘取金牌
摩步	摩托化步兵
支书	支部书记
政争	政治斗争
政团	政治团体
政工	思想政治工作
政改	政治体制改革
政校	政治学校
政院	政治学院
教卫	教育和卫生
教研	教学研究
文保	文物保护
文娱	文化娱乐
文摘	文章摘要
文教	文化教育
断交	断绝外交关系
新地	新鸿基地产
新航	新加坡航空公司
施压	施加压力
施袭	实施袭击
旅团	旅行团
无照	无牌照
日皇	日本天皇
日航	日本航空公司
日银	日本银行
早教	早期教育
时空	时间和空间
时评	时事评论
时限	时间限制
显效	显著效果
普九	普及九年制义务教育
普工	普通工人
普教	普通教育
智残	智力残疾
暨大	暨南大学
月入	每月收入
月均	每月平均
村企	村办企业
村委	村民委员会
林大	林业大学
标煤	标准煤
棉织	棉纺织
森工	森林工业
森警	森林警察
植保	植物保护
欧陆	欧洲大陆
正选	正式选举
武协	武术协会
武大	武汉大学
武联	武术联合会
民乐	民族音乐
民初	民国初年
民委	民族事务委员会
民贸	民族贸易
水保	水土保持
水运	水路运输
汤杯	汤姆斯杯
汽摩	汽车摩托车
汽配	汽车配件
沈铁	沈阳铁路局
油国	石油出口国
治保	治安保卫
治污	治理污染
治淮	治理淮河
治黄	治理黄河
波幅	波动幅度
泳协	游泳协会
泳手	游泳选手
浙大	浙江大学
海缆	海底电缆
温控	温度控制
港姐	香港小姐
港府	香港政府
港股	香港股市
游将	游泳健将
滥权	滥用职权
激辩	激烈争辩
炮团	炮兵团
烈属	烈士家属
物探	地球物理勘探
物耗	物资消耗
特困	特殊困难
特委	特别委员会
特批	特别批准
特训	特别训练
特需	特殊需要
环保	环境保护
环卫	环境卫生
环发	环境与发展
现值	现实价值
现况	现实情况
玻纤	玻璃纤维
生化	生物化学
田管	田间管理
电业	电力工业
电大	广播电视大学
电建	电力建设
电教	电化教学
电联	国际电信联盟
男乒	男子乒乓球
男单	男子单打
男双	男子双打
男曲	男子曲棍球
男网	男子网球
男花	男子花剑
留美	留学美国
监委	监察委员会
督查	监督检查
知青	知识青年
研发	研究开发
研考	研究生入学考试
社保	社会养老保险
社教	社会教育
社科	社会科学
社署	香港社会福利署
社群	社会群体
禁用	禁止使用
私企	私营企业
私宅	私人住宅
科协	科学技术协会
科研	科学研究
科考	科学考察
税制	税收制度
空战	空中作战
空政	空军政治部
空运	航空运输
童军	童子军
童装	儿童服装
筹资	筹集资金
管委	管理委员会
管护	管理和保护
管输	管道输送
篮协	篮球协会
篮赛	篮球赛
粮价	粮食价格
粮援	粮食援助
粮菜	粮食和蔬菜
精研	精心研究
纠风	纠正行业不正之风
红高	红色高棉
纳指	纳斯达克综合指数
纺机	纺织机械
组派	组织派遣
组训	组织训练
经委	经济委员会
经援	经济援助
经管	经济管理
经院	经济学院
统分	统一分配
统战	统一战线
统招	统一招生
统管	统一管理
续任	继续留任
维园	香港维多利亚公园
维港	维多利亚港
网协	网球协会
罗政	罗马尼亚政府
美协	美术家协会
美展	美术作品展览
美航	泛美航空公司
美院	美术学院
羽协	羽毛球协会
考纪	考试纪律
考纲	考试大纲
职中	职业中学
职总	职工总会
职校	职业学校
职棒	职业棒球
职高	职业高中
联保	联合保险
联共	联合共产党
联招	联合招生
联航	联合航空公司
聚赌	聚众赌博
股价	股票价格
股值	股票价值
育乐	体育娱乐
能耗	能源消耗
脱险	脱离危险
自民	自由民主
舞美	舞台美术
航校	航空学校
航母	航空母舰
艰困	艰难困苦
艺文	艺术文化
艺校	艺术学校
节市	节日市场
节支	节约开支
节水	节约用水
节电	节约用电
花市	花卉市场
英航	英国航空公司
药监	药品监督
莫大	莫斯科大学
营收	营业收入
蔬果	蔬菜水果
虫草	冬虫夏草
血检	血液检测
血防	血吸虫病防治
行止	行为举止
补税	补交税款
袭警	袭击警察
西画	西洋画
西语	西班牙语
观展	参观展览
观赛	观看比赛
规管	规划管理
触法	触犯法律
警校	警察学校
警署	警察署
计生	计划生育
议联	议员联盟
访京	访问北京
评优	评选优秀
评先	评选先进
话机	电话机
调研	调查研究
调资	调整工资
财困	财政困难
财年	财政年度
财金	财政金融
财长	财政部部长
责编	责任编辑
败因	失败原因
质保	质量保证
质监	质量监督
购股	购买股票
贸工	贸易和工业
赤几	赤道几内亚
超模	超级模特
越战	越南战争
足协	足球协会
足校	足球学校
跌势	下跌趋势
车管	车辆管理
轻卡	轻型卡车
边城	边境城市
边检	边防检查
边贸	边境贸易
辽沈	辽宁沈阳
运毒	运送毒品
运管	运输管理
运能	运输能力
运距	运输距离
违宪	违反宪法
速滑	速度滑冰
邮储	邮政储蓄
采供	采购供应
重审	重新审查
重教	重视教育
金饰	黄金首饰
钢研	钢铁研究
钱江	钱塘江
销势	销售形势
锡盟	锡林郭勒盟
长影	长春电影制片厂
长航	长江航运
长话	长途电话
长输	长途运输
防台	防御台风
防指	防汛抗旱指挥部
防贪	防止贪污
阿盟	阿拉伯国家联盟
附中	附属中学
附小	附属小学
附院	附属医院
陆航	陆军航空兵
陶艺	陶瓷艺术
青工	青年工人
非统	非洲统一组织
非行	非洲开发银行
音效	音响效果
领馆	领事馆
飞安	飞行安全
食油	食用植物油
首体	首都体育馆
首演	首场演出
马岛	马尔维纳斯群岛
马盟	阿拉伯马格里布联盟
马约	马斯特里赫特条约
马航	马来西亚航空公司
驾机	驾驶飞机
驾照	驾驶执照
高专	高等专科学校
高工	高级工程师
高师	高等师范
高干	高级干部
高息	高额利息
高检	最高人民检察院
高知	高级知识分子
高铁	高速铁路
高院	高级人民法院
黄陵	黄帝陵
一战后	第一次世界大战后
七运会	第七届全国运动会
上交所	上海证券交易所
世运会	世界运动会
世锦赛	世界锦标赛
世青赛	世界青年锦标赛
业委会	业主委员会
个体户	个体工商户
中东社	中东通讯社
中纪委	中央纪律检查委员会
临管会	临时管理委员会
五一节	五一国际劳动节
亚冬会	亚洲冬季运动会
亚锦赛	亚洲锦标赛
交通量	交通流量
人口所	人口研究所
伊通社	伊拉克通讯社
俄联邦	俄罗斯联邦
公用局	公用事业局
关工委	关心下一代工作委员会
副主委	副主任委员
动物所	动物研究所
北师大	北京师范大学
华师大	华东师范大学
南共体	南部非洲发展共同体
厂商会	香港中华厂商联合会
合同工	合同制工人
哈医大	哈尔滨医科大学
商交所	商品交易所
商标权	商标专用权
国开行	国家开发银行
国税局	国家税务局
国统区	国民党统治区
基民党	基督教民主党
基社盟	基督教社会联盟
外汇局	外汇管理局
外经贸	对外经济贸易
外贸部	对外贸易部
妇代会	妇女代表大会
妇女会	妇女协会
安委办	安全生产委员会办公室
安莎社	安莎通讯社
居委会	居民委员会
工业所	工业经济研究所
工博会	工业博览会
工展会	工业展览会
广电部	广播电影电视部
开发署	联合国开发计划署
心内科	心血管内科
心外科	心血管外科
总工会	中华全国总工会
投洽会	投资洽谈会
政研室	政策研究室
教科院	教育科学研究院
文艺界	文学艺术界
无人机	无人驾驶飞机
日用品	日常生活用品
时事社	时事通讯社
朝中社	朝鲜中央通讯社
植物所	植物研究所
欧空局	欧洲空间局
欧航局	欧洲航天局
民族宫	北京民族文化宫
民管会	民主管理委员会
民自党	民主自由党
民运会	少数民族运动会
汽修厂	汽车修理厂
法学所	法学研究所
法工委	法制工作委员会
深交所	深圳证券交易所
港澳办	港澳事务办公室
火电站	火力发电站
煤炭部	煤炭工业部
物理所	物理研究所
环保部	环境保护部
环委会	环境保护委员会
短训班	短期培训班
社保费	社会保险费
科考队	科学考察队
纪检委	纪律检查委员会
纺织部	纺织工业部
经团联	日本经济团体联合会
经适房	经济适用房
群艺馆	群众艺术馆
老龄委	老龄工作委员会
联交所	香港联合交易所
联储局	联邦储备局
联委会	联合委员会
自贸区	自由贸易区
花博会	花卉博览会
药物所	药物研究所
行政庭	行政审判庭
证交所	证券交易所
财委会	财政委员会
财经委	财政经济委员会
边检站	边防检查站
金管局	香港金融管理局
飞行队	飞行服务队
首师大	首都师范大学
黄委会	黄河水利委员会
万国邮联	万国邮政联盟
上海交大	上海交通大学
世卫组织	世界卫生组织
中东和谈	中东和平谈判
二次大战	第二次世界大战
交管部门	交通管理部门
人口老化	人口老龄化
住房改革	住房制度改革
全国青联	中华全国青年联合会
刑事技术	刑事科学技术
劳动人口	劳动年龄人口
劳动市场	劳动力市场
北京人艺	北京人民艺术剧院
北京体院	北京体育学院
台湾两岸	台湾海峡两岸
国家民委	国家民族事务委员会
国家经委	国家经济委员会
国家语委	国家语言文字工作委员会
国家防总	国家防汛抗旱总指挥部
国际举联	国际举重联合会
国际体联	国际体操联合会
国际棋联	国际象棋联合会
国际网联	国际网球联合会
国际羽联	国际羽毛球联合会
国际马联	国际马术联合会
地空导弹	地对空导弹
大众传媒	大众传播媒介
工业废物	工业固体废物
工发组织	联合国工业发展组织
巴解组织	巴勒斯坦解放组织
环发大会	联合国环境与发展大会
电子科大	电子科技大学
空地导弹	空对地导弹
联柬机构	联合国驻柬埔寨临时权力机构
西南交大	西南交通大学
非公经济	非公有经济
香港工联	香港工会联合会
马列主义	马克思列宁主义
国家体改委	国家经济体制改革委员会
国家工商局	国家工商行政管理局
国家计生委	国家计划生育委员会
拉美经委会	拉丁美洲和加勒比经济委员会
国际民航组织	国际民用航空组织
海湾合作委员会	海湾阿拉伯国家合作委员会
