研发	研究开发
协寻	协助寻找
禁用	禁止使用
停售	停止销售
停播	停止播放
参访	参观访问
产销	生产和销售
举发	检举揭发
劳改	劳动改造
续任	继续留任
宣导	宣传引导
坚拒	坚持拒绝
拒付	拒绝支付
减让	减税让利
宣教	宣传教育
拒收	拒绝接收
组训	组织训练
督查	监督检查
调研	调查研究
参训	参加训练
规管	规划管理
参会	参加会议
批捕	批准逮捕
巡展	巡回展出
批建	批准建设
管护	管理和保护
打防	打击和防范
投建	投资建设
采供	采购供应
巡讲	巡回演讲
参试	参加试验
防贪	防止贪污
聚赌	聚众赌博
收审	收容审查
委培	委托培养
组派	组织派遣
控申	控告申诉
协处	协助处理
创演	创作和演出