城理	城市理工	香港城市理工学院
工青妇	工会青年团和妇联	工人青年和妇女
幼师	幼儿师范学校	幼儿师范
公共关系公司	公共关系咨询公司	公共关系顾问公司
组委	组织委员	组织委员会
计控	计量控制	计算机控制
邮联	邮政联盟	集邮联合会
农水	农田水利	农村水利
党代会	党代表大会	党的代表大会
计控室	计量控制室	计算机控制室
党支书	党支部书记	党总支书记
华师大	华中师范大学	华南师范大学
中旅	中国旅行剧团	香港中旅集团有限公司
军统	国民政府军事委员会调查统计局	军统局
幼托	幼儿园和托儿所	幼儿园托儿所
少先队	中国少年先锋队	少年先锋队
省高院	省高级检察院	省高级法院
植生所	植物生理所	植物生理研究所
家装	家居装饰	家居装修
道指	道琼斯股票价格平均指数	道琼斯指数
澳队	澳门队	澳大利亚队
民柬	民主柬埔寨	民族柬埔寨
环评	环境评估	环境评价
文革	无产阶级文化大革命运动	文化大革命
编办	编辑部办公室	编制办公室
水旱	水田和旱地	水田旱地
中百	中国百货公司	中国百货
电教室	电化教学实验室	电化教育教研室
工委	工作委员会	工委会
中转	中途转运	中间转卖
广电部	广播电影电视部	广播电视部
寒暑期	寒暑假期间	寒假暑假期间
音美	音乐美术	音乐和美术
税负	所得税的负担	税务负担
航摄	航空拍摄	航空摄影
中修	中期维修	中等维修
台港澳	台湾香港和澳门	台湾香港澳门
女网	女子网球	女子网球队
车模	汽车模型	汽车模特
影展	电影展映	摄影作品展览
个展	个人作品展	个人作品展览
团友	旅游团朋友	新民主主义青年团之友
自民党	自由民主党	自由民主党
政协	政治协商	中国人民政治协商会议
蒋管区	蒋介石集团统治管辖的地区	蒋介石集团统治管辖地区
劳协	劳动协会	劳动者协会
工农商学	工人农民商人和学生	工业农业商业和学校
黄泛区	黄河洪小泛滥区域	黄河洪水泛滥区域
残联	残疾人联合会	残疾人联合会
人大会	人民代表大会	人民代表大会
二战	第二次世界大战	第二次世界大战
南汽	南京汽车制造厂	南京汽车
老庄	老子和庄子	老子庄子
文体	文娱体育	文化体育
药检	药品检验	药物检查
国奥	中国奥林匹克足球队	国奥队
抽检	抽样检查	抽样检测
农建	农业建设	农村建设
彻查	彻底追查	彻底调查
影协	电影家协会	摄影家协会
海协	大陆海峡两岸关系协会	海协会
林果	林业果业	林木和果木
南委	中共中央南方工作委员会	南长区委
房委会	住房管理委员会	房屋顾问委员会
特护	特级护理	特殊护理的护士
研修	研究进修	研究修订
四化	四个现代化	四个现代化
执委	执行委员会委员	执行委员会
农工副	农业工业副业	农业工业和副业
中国社科院	中国社会科学院	中国社会科学院
中航	中国民航	中国航空公司
残奥	残疾人奥林匹克运动会	残奥会
伊盟	内蒙古自治区伊克昭盟	伊斯兰教世界联盟
南航	南方航空公司	南京航空学院
职校	职业技术学校	职工学校
外经部	外经贸部	对外经济贸易部
农技员	农业技术人员	农业技术员
中青网	中国青年网	中国青年网球队
北航	北京航空航天大学	北京航空航天大学
职训	职业训练	职业训练中心
复退	复员退伍	复员和退伍
征管	征收和管理	征收管理
教风	教学学风	教学作风
少代会	中国少年儿童先锋队代表大会	少年代表大会
文管会	文物管理委员会	文教接管委员会
名优	名牌产品优质产品	名牌优质
欧行	欧洲银行	欧洲旅行
草委	起草委员	起草委员会
港九	香港九龙	香港和九龙
全运	全运会	全国体育运动会
竹艺	竹制品工艺	竹制品艺术
银企	银行和企业	银行企业
核试	核武器试验	核试验
共青团	中国共产主义青年团	共产主义青年团
检测	检查和测试	检验和测定
北外	北京外语学院	北京外国语学院
武委会	武术委员会	人民武装委员会
全员	全体成员	全体员工
中青队	中国青年队	中国青年足球队
高法	最高人民法院	高级人民法院
全运会	全国运动会	全国体育运动会
社工	社会群众工作	社会工作
政教	政治和宗教	政治教育
婚介所	婚姻介绍所	婚姻介绍所
文委	文化工作委员会	文化教育委员会
干训	干部培训	干部训练
生资站	生产资料站	生产资料供应站
功模	功臣模范	功臣和模范
中行	中央银行	中国银行
中汽	中国汽车工业总公司	中国汽车工业
复转	复员和转业	复员转业
卫视	香港卫星电视有限公司	卫生电视
粮管所	粮食管理所	粮油管理所
文管	文物管理	文化管理
幼教	幼儿教育	幼儿教育系统
教辅	教学辅导	教学辅助
证监	香港证券期货交易监督委员会	证券监管
管控	管理控制	管理和控制
咨委	咨询委员会	咨询委员会委员
微机	微型计算机	微型计算机
主委	主任委员	主选委员
刑诉法	刑事诉讼法	刑事诉讼法
工代会	工代大会	工人代表大会
公教	公务和教学	公务教学
少教	少教人员	少年收容教养人员
峨影	峨嵋电影制片厂	峨眉电影制片厂
丁肝	丁型肝炎	丁型病毒性肝炎
机扫	计算机扫描	机器扫描
机运	机械运输	飞机运输
常委会	常务委员会	常务委员会
冬运会	冬季运动会	冬季运动会
小教	小学教育	小学教师
中教	中等教育	中学教师
农博会	农业博览会	农业食品博览交易会
粮棉油	粮食棉花和油料作物	粮食棉花油料作物
一野	中办民解放军第一野战军	中国人民解放军第一野战军
捷通社	捷克通讯社	捷克斯洛伐克通讯社
女大	延安中国女子大学	女子大学
中油	中国石油工程建筑公司	中国石油公司
理化生	物理化学生物	物理化学和生物
托幼	托儿所幼儿园	托儿所和幼儿园
交管站	交通管理检查站	交通管理站
艺委会	艺术教育委员会	艺术委员会
二战	二次大战	第二次世界界大战
职大	职工业余大学	职业大学
商交会	商品交易会	商品交易会
银贸	银行外贸	银行和外贸
女篮	女子篮球队	女子篮球队
书报刊	图书报纸期刊	图书报约期刊
捐赠办	接收救灾捐赠办公室	接受救灾捐赠办公室
机检	计算机检索	机器检验
侨办	国务院华侨事务办公室	侨务办公室
八卦掌	游身八卦掌	八卦连环掌
中福会	中国福利会	中国福利基金会
亚视	香港亚洲电视广播有限公司	亚洲香港电视广播有限公司
影艺	电影艺术	摄影艺术
违建	违反规章制度的建筑	违反规章制度而建筑
哈工大	哈尔滨工业大学	哈尔滨工大
县直	县委和县政府的直属机关	县委和县政府直属机关
政经	政治经济学	政治经济
北医大	北京医科大学	北京医科大学
中电	香港中华电力有限公司	中央电影企业股份有限公司
粮油	粮食油料	粮食和油料
文委	文委会	文艺委员会
技考委	技术考核委员会	技考委员会
呼盟	呼伦贝尔盟	呼伦贝尔盟
北科大	北京科技大学	北京科学技术大学
粮管	粮食管理	粮油管理
电教室	电化教学室	电化教学教研室
国际曲联	国际曲棍联	国际曲棍球联合会
消协	消费者协会	消费者协会
深指	深圳股票指数	深圳证券指数
房管办	房产地产管理办公室	房屋管理办公室
亚大地区	亚洲和大洋洲地区	亚洲和大洋州地区
编委会	编纂委员会	编辑委员会
肝衰竭	肝功能衰竭	肝细胞衰竭
旱涝	旱灾和涝灾	旱灾涝灾
教代会	教师代表大会	教职工代表大会
汽修业	汽车修理行业	汽车修理业
全国人大	全国人民代表大会	全国人民代表大会
西安交大	西安交通大学	西安交通大学
资审	资信审查	资格审查
控办	控制社会购买力办公室	控制社会集团购买力办公室
刑检	刑事检察	刑事检查
职教	职业教育	职工教育
北图	北京图书馆	北京图书馆
北农大	北京农业大学	北京农业大学
环保法	环境保护法	环境保护法
中试	中间试验	中期试验
支委会	党支部委员会	支部委员会议
北林大	北京林业大学	北京林业大学
整改	整顿改进	整顿改革
先心病	先天性心血管病	先天性心脏病
文史	文学和历史学	语文和历史
社教部	社会主义思想教育部	社会科学教育部
纪委	纪律检查委员会	纪检委
国统	国民党统治	国家统配
西北工大	西北工业大学	西北工业大学
春交会	春季出口商品交易会	春季交易会
驻京办	驻京办事处	驻北京办事处
文工队	文化艺术工作队	文化艺书术工作队
总政	红军总政治部	中国人民解放军总政治部
期指	恒生期货指数	期货指数
工联	工联会	工会联合会
纺工部	纺织工业部	纺织工业部
政制	政治制度	政治体制
文抗	文艺界抗敌后援会	全国文艺界抗日联合会
彩电	彩色电视	彩色电视机
联大	联合国大会	联合国大会
中国作协	中国作家协会	中国作家协会
电工部	电力工业部	电子工业部
文委会	文化工作委员会	文化教育委员会
普小	普通小学	普及小学
直供	直接供应	直接供销
外委会	外事委员会	外务委员会
欧共体	欧洲共同体	欧洲共同体
中科院	中国科学院	中国科学院
扩军	扩充军备	扩充军队
品学	品行学业	品行和学业
奥赛	国际学科奥林匹克竞赛	奥林匹克学科竞赛
村干	村级干部	村干部
干群	干部和群众	干部群众
中共	中国共产党	中国共产党
城市理工	香港城市理工大学	香港城市理工学院
一百	第一百货商店	第一百货公司
亚太	亚太地区	亚洲和太平洋地区
政工办	政治工作办公室	政策工作办公室
中大	中文大学	中央大学
企业办	企业办公室	企业管理办公室
红大	中国人民抗日红军大学	中国工农红军大学
科影	科影厂	科学教育电影制片厂
农调	农村社会经济调查	农村调查
声镜	声学显微镜	超声显微镜
直航	直接通航	直达航线
安理会	安全理事会	联合国安全理事会
朝医	朝鲜族医学	朝医学
名校	知名学校	著名学校
根艺	根雕艺术	树根造型艺术
资信	投资信贷	资金和信用
技侦	技术侦察	技术侦查
环保署	环境保护署	香港环境保护署
黄毒	黄色毒素	黄色毒品
教改	教学改革	教育改革
教职	教员职员	教师职务
特教	特殊教育	特级教师
亚太经社会	联合国亚洲和太平洋经济社会委员会	亚洲和太平洋经济社会委员会
高检	中华人民共和国最高人民检察院	高检院
一建公司	第一建筑工程公司	第一建筑安装公司
筹委会	筹备委员会	筹备委员会
邮发	邮递和发行	邮政发行
工运史	工人运动历史	工人运动史
特工	特务工作人员	特务工作
厂办	厂长办公室	工厂办会室
国商	国际商业信贷银行	国商银行
职级	职务和等级	职务级别
体师	体育师范学校	体育师范学院
政研	行政与科研	政策研究
义工	义务工作者	义务工作
电教办	电化教育办公室	电化教学办公室
工农比价	工农业商品交换比价	工农业商品比价
中委会	中央委员会	中央委员会
民调	民意调查	民事调解
惩教	惩罚教育	惩罚和教育
一战	第一次世界大战	第一次世界大战
革委会	革命委员会	革命委员会
体卫	体育卫生	体育和卫生
核武库	核武器库	核武器仓库
丙肝	丙/Mg 型病毒性肝炎	丙/Mg 型肝炎
选委会	选举委员会	选举委员会
彩管	彩色管	彩色显像管
刚布	刚果布拉柴维尔	刚果布
规费	规划费用	国家规定上缴的各类管理费
考录	经考试录取	考试录用
律联	律师联盟	律师联合会
办结	办理并了结	办理了结
学委	学习委员	学习委员会
财办	财贸办公室	财政办会室
社科院	社会科学院	社会科学院
化工部	化学工业部	化学工业部
农运会	农民体育运动会	农民运动会
5中	第55中学	第5中学
民运	少数民族运动会	民众运动
高法	中华人民共和国最高人民法院	最高法院
税政	税收政策	税收政治
刚金	刚果金	刚果金沙萨
农林牧副渔	农业林业牧业副业渔业	农业林业畜牧业副业和渔业
中央社	中央通讯社股份有限公司	中央通讯社
干管	干线管线	干部管理
廉署	港督特派廉政专员公署	香港特别行政区廉政公署
客货	旅客和货物	旅客货物
高教	高等教学	高等教育
特检	特别检查	特区检查
音像	录音带和录像带	录音和录像
医管局	医疗管理局	医院管理局
收教所	妇女收容教育所	收容教育所
自控	自我控制	自动控制
农八师	新疆生产建设兵团农八师	新疆生产建设兵团农八师
译联	翻译工作者联合会	翻译工作者联和会
文艺	文化艺术	文学艺术
北工大	北方工业大学	北京工业大学
文协	中华全国文艺界抗敌协会	中华全国文学工作者协会
华约	华沙条约	华沙条约及其组织
技工	技术工作	技术工人
水保所	水土保持研究所	水土资源保护研究所
重汽	重庆汽车制造厂	重型汽车
轻工部	中华人民共和国轻工业部	轻工业部
防总	防汛总部	防汛总指挥部
理工	理工科	理科和工科
奥运会	奥林匹克运动会	奥林匹克运动会
罗新社	罗马尼亚新闻社	罗马尼亚新华社
体联	体育联合会	体操联合会
农轻重	农业轻工业和重工业	农业轻工业重工业
职代会	职工代表大会	职工代表大会
珠峰	珠穆朗玛峰	珠穆朗玛峰
外委会	外交委员会	对外关系委员会
群防	群众参与预防	群众防病治病
外调	向外调运	外出调查
哈工大	哈儿滨工大	哈尔滨工业大学
教委	教育委员会	教育委员会
外长	外交部长	外交部部长
计委	计划委员会	计划委员会
一汽	长春第一汽车制造厂	第一汽车公司
省运会	省级运动会	省体育运动会
亚运	亚运会	亚洲体育运动会
一国两制	一个国家两种社会制度	一个国家两种制度
文卫	文教卫生	文化卫生
医护	医生和护士	医疗护理
中土	中国土木工程公司	中国国土
女手	女子手球	女子手球队
县社	县和人民公社	县供销合作社
果蔬	水果和蔬菜	水果蔬菜
调训	调整和训练	调集培训
酌处	酌情处理	酌情处罚
欧锦赛	欧洲足球锦标赛	欧洲锦标赛
质监站	质量监督联络站	质量监督站
